haitang: 海塘、海棠
anjie: 按揭
huapi: 画皮
guohua: 国花、国画
hezai: 荷载、和在
hunshi: 混事
bishun: 笔顺
chenghuang: 橙黄
huangdi: 荒地、黄帝、皇帝
hebang: 河浜
huanhen: 还很
gongnei: 宫内
gangwei: 岗位
hunhe: 混和、混合
changzhen: 唱针
aima: 挨骂
cangliang: 苍凉
cuandao: 蹿到
bitao: 笔套
erzi: 儿子、耳子
daoshi: 到时、道士
jiaao: 夹袄
dingshi: 定时
huiji: 徽记、回击、秽迹、汇集、汇寄、讳忌
guwen: 古文
huangang: 换岗
chuishou: 垂手
chengbei: 城北、成倍
diuren: 丢人
fanlu: 翻录
chaoqian: 超前
antou: 案头
baji: 坝基
biti: 鼻涕、笔体
jihen: 记恨
binggu: 病故
chongshua: 冲刷
fengfu: 丰富
guoqiang: 国强
dongyong: 动用
canjia: 参加
chunpu: 淳朴
erfu: 耳福、二副
baiqu: 白区
gongyuan: 共圆
jipin: 极品、济贫
henda: 很大
guohui: 国徽、国会
fanshou: 反手
anshuo: 按说
gongxia: 攻下
gedai: 隔代
chenghun: 成婚
huashui: 滑水
guandeng: 关灯
chedi: 彻底
huangei: 还给
duichang: 堆场、队长
jigong: 机工、技工、济公、记功
babai: 八百
anhui: 安徽
gongwei: 恭惟
anliu: 暗流
chengyao: 成药
fanwen: 反问、范文
biancheng: 边城
cixiu: 刺绣
huosheng: 获胜
guidang: 归档
jiyuan: 机缘、积怨
benxiao: 本校
huanxing: 环形、环行、还行、唤醒
gouchong: 钩虫
caiyin: 彩印
feibang: 匪帮、诽谤
bizhu: 比诸
bingxing: 秉性、并行
chongshang: 崇尚
cengmian: 层面
ezha: 讹诈
biaozhang: 表彰
huanban: 换班
burang: 不让
anpei: 安培
guangzhou: 广州
dunguo: 蹲过
dapo: 打破
benban: 本版
bingyuan: 兵员、兵源、病员、病源、病院
bangguang: 膀胱
baotou: 报头
bendang: 本党
ducu: 督促
haiyan: 海燕
guodu: 国都、国度、过度、过渡
baofa: 暴发
chubu: 初步
buzu: 补足、不足
binqi: 摈弃
canpo: 残破
bieti: 别提
fucang: 赴藏
hangxing: 航行
chiyou: 持有
chahu: 茶壶
guangkuo: 广阔
gejue: 隔绝
chongdong: 冲动
fanran: 翻然
dingyan: 鼎言
beiying: 背影
caiken: 才肯
dianhua: 点化、电化、电话
biaoke: 表壳
daogui: 捣鬼、道规
budan: 不丹、不单、不但
fangzu: 房租
echuan: 讹传
chujian: 初见
aijian: 挨肩
gucheng: 古城
bagua: 八卦
haiwai: 海外
gengfan: 更番
danji: 淡季
bingzhan: 兵站
biaoqin: 表亲
chenmin: 臣民
dibu: 抵补、底部、地步
boqu: 剥去、博取
houpa: 后怕
hanyou: 罕有
ganse: 干涩
guizhao: 跪着
bijia: 比价、笔架
banpo: 半坡
huanxi: 换洗
jiashi: 家史、家事
guodi: 过低
guozhang: 过帐
duke: 都可
jidiao: 基调
banshang: 班上、搬上
buxun: 不逊
dianpu: 店铺
hunshui: 昏睡、混水
ganyue: 干哕
dongshou: 动手
guizu: 贵族
huoshi: 获释、或是、祸事
duju: 赌局、赌具
feiwo: 肥沃
fanchang: 反常
gumu: 古墓
guazhong: 挂钟
biaolv: 表率
bocai: 菠菜
chanjia: 搀假、掺假
diwen: 底纹
bikai: 避开
douchu: 抖出
gangban: 钢板
chengguo: 成果、乘过
fangwei: 防伪、防卫
bentai: 本台
hongqiao: 虹桥
huaju: 话剧
beibu: 北部、背部、被捕
daidai: 呆呆
cabei: 擦背
bodi: 泊地
dapei: 搭配
banpiao: 半票
caitao: 彩陶
bubi: 补笔、不比、不必
bailiang: 白亮
guojue: 果决
chongxiang: 冲向
boduo: 剥夺
bingrong: 病容
dipu: 地铺
zhaohou: 朝后
benzhuo: 笨拙
benhua: 本画
hunzhuo: 混浊
chuanghu: 窗户
gebo: 胳膊
banzhu: 斑竹、班主、扳住
dingji: 定级
baixie: 拜谢
cideng: 次等
guasha: 刮痧
hanlu: 寒露
bubao: 补报
aikou: 碍口、隘口
banbo: 斑驳
baxi: 巴西、把戏
chenzhao: 沉着、趁着
chulian: 初恋
hele: 和乐
huanmei: 还没
huhu: 呼呼
guanshang: 关上、官商
dangan: 胆敢、档案
gugong: 故宫、雇工
chuanpiao: 船票
hanyu: 汉语
chuangshang: 床上
hantian: 寒天、旱天
bingjian: 兵舰、兵谏、并肩
dezhou: 德州
gengkuai: 更快
huijue: 回绝
baochu: 报出
chajing: 茶晶
dacong: 打从
heshang: 和尚、河上
cashen: 擦身
chibi: 池壁
chibei: 赤背
cancha: 参差
chengzai: 成灾
foujue: 否决
jibing: 疾病
chouchong: 臭虫
bozang: 薄葬
banzhong: 拌种
chengzhi: 称职、惩治、诚挚
changchang: 场长、长长、厂长
anzhuang: 安装
hujiu: 呼救
hongtu: 宏图
chalu: 插录、茶炉
boming: 薄命
chayuan: 茶园
hunmi: 昏迷
haoling: 号令
binguan: 宾馆
changgong: 长工
bianpo: 鞭笸
guocuo: 过错
benfei: 本非
chonger: 宠儿
ayi: 阿姨
fanpai: 翻拍、翻牌、反派
chuangru: 闯入
daizhu: 逮住
beitie: 碑帖
cixie: 辞谢
fenggou: 疯狗
hubang: 互帮
chiyi: 迟疑
fenhui: 焚毁
baizheng: 摆正
chuanci: 穿刺
chengshang: 呈上、乘上
fanyi: 翻译
gexia: 割下、阁下
gandie: 干爹
haibing: 害病
fangshen: 防身
cainuan: 采暖
aida: 挨打
diaodong: 调动
jihua: 激化、计划
duanluo: 段落
heishao: 黑哨
benan: 本案
jijin: 基金、激进、疾进、几近
huigui: 回归
huabu: 花布、画布
anzi: 鞍子、暗自、案子
hanqia: 汉卡
benhuo: 笨活
huanqian: 换钱
chunmei: 淳美
anning: 安宁
baobiao: 报表
haizhe: 海蜇
gangzhao: 杠着
douyou: 兜游、豆油
daizou: 带走
changhe: 场合、长河
dingpiao: 订票
beituo: 碑拓
chuqian: 出钱
chiyan: 迟延
caoxing: 操行
caidan: 菜单
huandiao: 换掉
anzhao: 按照
huangdong: 晃动
chazheng: 查证
fanwu: 反诬
defen: 得分
changji: 昌吉、场记、长机、长畸、唱机
biaobing: 标兵
fansuo: 反锁
huizhang: 徽章、回涨
cidie: 磁碟
diaodu: 调度
erqi: 而其
fenfang: 芬芳
canchong: 蚕茧
huangzai: 蝗灾
dianming: 点明、点名
bujiu: 补救、不久
budu: 不独
beiyue: 北约
chuancang: 船舱
bingchuang: 冰床、病床
fengmao: 丰茂、风貌
chenghuo: 成活
choudiao: 抽掉、抽调
huojie: 活结
henbu: 很不
huapian: 画片
geda: 疙瘩
chengfeng: 成风
hengcai: 横财
hongliu: 洪流
donghai: 冻害
chengjia: 成家
guigang: 硅钢
hechu: 喝出
guaizhang: 拐杖
baoguo: 报国
guanshi: 官势
caimei: 采煤
geduan: 割断、隔断
caichang: 菜场
hengbo: 横波
fuyue: 赴约
hetan: 和谈、河滩
geju: 割据、格局、隔居
baoshe: 报社
cangfu: 藏富
huazhu: 花烛
daoren: 刀刃、到任
bieku: 别哭
hezhe: 赫哲
choujian: 抽检、筹建、瞅见
chixiang: 吃香
bushuo: 不说
dixiao: 抵消、地效
hanwen: 罕闻
ciwei: 刺猬
huangyang: 黄羊
chuile: 吹乐、吹了
gongjin: 共进
jiajuan: 家眷
genbu: 根部
hese: 褐色
cunli: 村里
fuman: 服满
bumian: 不免
dongshen: 动身
bafang: 八方
jiren: 记认
faxue: 法学
hemu: 和睦
gangzi: 缸子、杠子
huanhui: 还会、换汇
cheye: 彻夜
chiru: 耻辱
ciri: 次日
bupei: 不配
haichu: 害处
huixiu: 回修
chouchang: 愁肠
fugai: 覆盖
heneng: 核能
fengci: 讽刺
biaoshi: 标识、标示、表示
huangfu: 皇甫
heliu: 河流
dieluo: 跌落
caibian: 采编
henghuo: 横祸
dunwu: 顿悟
dinge: 定额
jide: 积德、记得
jitui: 击退
caidian: 彩电
bugao: 补膏、不高
cishu: 辞书、次数
gongqing: 恭请、共庆
huayuan: 花园、画院
daobie: 道别
bashe: 跋涉
gaishu: 该书、该署、概述
chuqin: 出勤
chengke: 乘客
huaer: 花儿
dengjia: 等价
bianmen: 边门
erying: 而应
bingzhuan: 冰砖、并转
huache: 花车
anfen: 安分
changli: 厂里
gangdao: 刚到、钢刀
huaqiang: 花枪、花腔、花墙
buding: 补丁、不定
cang*: 藏*
chuangta: 床榻
fengneng: 风能
caolian: 操练
hangban: 航班
fengwei: 风味
chawu: 查无
caizi: 菜子
fengkuang: 疯狂
bifen: 比分
dianbiao: 电表
erwen: 耳闻
biaoyu: 标语
huoduan: 祸端
gangqian: 钢钎
huoxing: 活性
haican: 海参
jilin: 吉林
henqiang: 很强
chuer: 初二
aibing: 癌病
bashi: 八十、巴士、罢市
chajian: 查检
feijiao: 吠叫
chengben: 成本
buzhu: 补助
chengxiang: 城厢、城乡、成像
jiche: 机车
fuzu: 富足
buxiao: 不消、不小、不孝、不肖
hanshuang: 寒霜
changxiang: 长相、畅想
cehui: 测绘
bozhong: 播种
diepo: 跌破
dongtai: 动态
dongliang: 栋梁
baishu: 白薯、白术
hezhang: 河障
huangquan: 黄泉
fanling: 翻领
heilian: 黑脸
jiang: 激昂
changqiang: 长枪、唱腔
huijing: 回京、回敬
cizhi: 辞职、次之
zhaodong: 朝东
guangmo: 广漠
huating: 花厅、划艇
huaiju: 淮剧
banzhuo: 板桌
guohun: 国魂
bingcun: 并存
huarui: 花蕊
hewo: 和我
chengtou: 城头
guocheng: 过程、过秤
deyu: 德语、德育
dianfen: 淀粉
daodou: 刀豆
jiafu: 家父
hemei: 和美、褐煤
banle: 扳了、办了
jizu: 机组
bianfu: 边幅
dongxi: 洞悉
fangong: 翻供、反攻、返工
dianying: 电影
jiku: 极苦、疾苦
cisha: 刺杀
dupian: 读片
danlve: 胆略
baokan: 报刊
huojian: 活检
bianci: 贬词
bizheng: 痹症
huaqian: 花钱
huiying: 回应
baihao: 摆好
cengshu: 层数
beikuang: 背筐
chengwei: 称为、称谓、成为
ganxiao: 干校
buyong: 不用
bailun: 摆轮
cimao: 刺毛
guazhao: 挂着
ganghua: 钢花
husheng: 呼声、互生
changchun: 长春
buqu: 不屈、不去
chujing: 出境
huangyuan: 荒原
huangzi: 皇子、幌子
emao: 鹅毛
caiban: 采办
hengbi: 横笔
hushui: 湖水
jixiong: 吉凶
dier: 第二
hanre: 寒热
chajin: 插紧、插进、查禁
baoxiu: 报修
eyu: 恶语
chehuan: 撤换
jihuo: 激活
guogai: 锅盖
guanzhu: 关注、灌注、贯注
changsuo: 场所
huiyi: 回忆
hanji: 寒季、旱季、汗迹
daixie: 带些
houlong: 喉咙
guansi: 官司
dongfang: 洞房
baibi: 败笔
jidian: 基点、机电、极点、几点、几钿
caogang: 槽钢
changnei: 场内、厂内
edu: 额度、恶毒
dange: 耽搁
hengsao: 横扫
huaichu: 坏处
doupeng: 斗篷
dazhao: 打着
biaoduan: 标段
aidai: 爱戴
baocang: 宝藏
hushe: 互设
chaoxi: 潮汐
hemiao: 禾苗
daogu: 捣鼓、稻谷
guanqu: 灌区
boai: 博爱
ankang: 安康
heidou: 黑豆
daoshou: 到手
chilu: 赤露
guantong: 贯通
hennong: 很浓
buhen: 不很、不恨
duorang: 躲让
guifu: 贵妇
bengchuang: 蹦床
banwen: 斑纹
jiaxing: 嘉兴
feizhi: 废址、废止、废纸、废置
guobin: 国宾
bide: 逼得
jijiao: 计较
chaiqu: 拆去
huacao: 花草
bianbai: 扁柏
cengci: 层次
gangqi: 杠起
guagou: 挂钩、挂勾
fanqing: 返青
ciai: 慈爱
hualian: 花脸
gengshao: 更少
balu: 八路
duanwei: 段位
cade: 擦得
beipan: 背叛、被判
huoxie: 活血
biyou: 庇佑
chuzou: 出走
cuilv: 翠绿
daidian: 带电
chuanwu: 船坞
haixiu: 害羞
binchi: 摈斥
guaguo: 瓜果、挂果
fanqie: 番茄
guoda: 国大、过大
bengta: 崩塌
dongkai: 洞开
chongyi: 充溢
jikan: 季刊
douxiao: 逗笑
diaoshi: 调试
choutou: 抽头
changxu: 畅叙
jiadai: 夹带
douli: 兜里、斗笠、陡立
hengbin: 横滨
caijing: 财经
huxiao: 呼啸、虎啸
huanshi: 环视、还是
gaoqing: 告罄
heping: 和平
bake: 罢课
esha: 扼杀
heshi: 核实
dengtong: 等同
elie: 恶劣
benyi: 本已、本意、本义
chuangwai: 窗外
caoyue: 草约
duliang: 肚量、度量
chabei: 茶杯
caoni: 草拟
chumian: 出面
caizai: 踩在
guben: 股本
diaoti: 吊提
biezou: 别走
gandan: 肝胆
chongsan: 冲散
hongguan: 宏观
deshou: 得手
chongyu: 充裕
haisi: 害死
goutu: 构图
caijian: 裁剪、裁减
ganglou: 岗楼
bikong: 鼻孔、碧空
huogai: 活该
gandian: 赶点
bazhang: 巴掌
duzhan: 督战
anyi: 安逸
choucha: 抽查
gunlun: 滚轮
gongfu: 功夫
bingdu: 病毒
canmou: 参谋
huairen: 坏人
erbian: 耳边
huanba: 还把
jixiao: 讥笑、极小、技校
dianhuo: 点火
houniang: 后娘
caolao: 操劳
huoer: 活儿
bushe: 不舍
ciyu: 词语、赐予、次于
bingxie: 冰鞋
gonggao: 功高
feizhou: 非洲
zhaoyang: 朝阳
ganhui: 赶回
bianzhai: 边寨
buji: 不及、不急、不计、不洁、不羁
chuji: 初级、出击
guibao: 瑰宝
jiyang: 激扬、技痒、寄养
endian: 恩典
aifu: 爱抚
bosha: 搏杀
houwu: 后屋
fuming: 浮名
gaizhi: 钙质
bingdong: 冰冻
bingjun: 病菌
baibu: 白布、白醭、摆布
antuo: 安妥
gusheng: 鼓声
heihai: 黑海
caiyong: 采用
chengnan: 城南
biaoyou: 标有
diantai: 电台
dingzao: 订造
chouma: 筹码、臭骂
gangren: 港人
doulv: 豆绿
daodian: 到点
dianbao: 电报
gaiju: 该剧
chengqing: 呈请、澄清
cangkou: 舱口
dalie: 打猎
dabian: 答辩
fuxing: 服刑、福星
dianping: 电平、电瓶
guzi: 骨子
hexi: 贺喜
anzhu: 按住
cangqing: 藏青
baiyan: 白眼
benyuan: 本原、本源、本愿、本院
chengyin: 成荫、成因
bilin: 比邻
haisun: 海损
guanjun: 冠军
jigen: 几根
banzui: 拌嘴
huansu: 还俗
danshui: 淡水
ganzao: 干燥、赶早
biaogao: 标高
dingzheng: 订正
daxia: 打下
bangtie: 榜贴
cihui: 词汇
guocui: 国粹
chongdi: 冲抵
bianjiao: 边角
diben: 底本
fanyun: 贩运
chongsai: 充塞
beinei: 杯内
chuipai: 吹拍
caiyao: 菜肴
haohan: 浩瀚
hongyan: 鸿雁
chumen: 出门
diedao: 跌倒、跌到
fenggan: 风干
buzhuo: 捕捉
guangbo: 广播、广博
caoan: 草案
caomu: 草木
hefeng: 和风
banyun: 搬运、拌匀
bukuai: 捕快、不快
jifeng: 讥讽、疾风
dingluo: 钉螺
gankuai: 赶快
heibu: 黑布
chuge: 出格
daichu: 带出
ansha: 暗杀
chanshu: 阐述
caochi: 操持
chitang: 池塘
ganqiao: 赶巧
caifu: 财富
daoju: 刀具、道具
chudong: 初冬、出动、出洞
hongwei: 宏伟
buran: 不然
gangjian: 刚健、港监
chijiao: 赤脚
bozhi: 薄纸
biaodian: 标点
baishi: 白事、摆式、败事、拜师
fangye: 防夜
buda: 不大
jizhun: 基准
caigou: 采购
fanli: 樊篱、范例
hengshu: 横竖
erdeng: 二等
huayu: 话语
dujue: 杜绝
dite: 敌特
fuzhu: 腐竹、附注
gunyuan: 滚圆
jian: 积案、吉安
fuse: 肤色、服色
gengwei: 更为
fulu: 附录
biandou: 扁豆
guangchang: 广场
aba: 阿爸
fanren: 凡人
chusai: 初赛
huazhou: 画轴
guotou: 过头
anqi: 氨气、按期、暗器
huige: 挥戈
huwai: 户外
haisao: 害臊
jilu: 记录
ganma: 干妈、干吗
hunjin: 混进
dousha: 豆沙
benben: 本本
fangshi: 房事
chuiwei: 垂危
canjin: 餐巾
ganchao: 赶超
jiagui: 家规
gongxing: 拱型、共性
beilou: 背篓
dunzi: 墩子
henku: 很苦
gangyao: 刚要
chuqi: 初期、出奇、出气
bushao: 不少
chuchou: 出丑
huahong: 花红
diwu: 第五
dayang: 打样、打烊
bieyou: 别有
fuqian: 肤浅、浮浅
guankui: 管窥
diaohu: 调护
beiqie: 悲切、卑怯
chinei: 池内
dianshe: 点射
zhaoxiang: 朝向
huoxi: 获悉
hongpian: 哄骗
boxia: 剥下、播下
guantou: 关头、罐头
buhui: 不回、不会、不讳
chuanhao: 串号
hualiu: 滑溜
guanxian: 官衔、管线
dianwang: 电网
bieren: 别人
anli: 按理、按例、暗里、案例
bieke: 别克
gangjin: 钢筋
fumian: 幅面、浮面
chayue: 查阅
haishe: 海蛇
gewai: 格外
bilei: 壁垒
haipai: 海派
canlian: 残联
duxie: 读写
ejiao: 额角
beitou: 被头
cangqiong: 苍穹
huaxiang: 滑翔、滑向、画像
diandu: 电镀
fuxiang: 浮想、福相
cangbao: 藏胞
faren: 法人
diliu: 第六
dengche: 蹬车
fanbu: 帆布
bancai: 板材
fengbao: 风暴
chuxuan: 初选
doulou: 抖漏
baimao: 白猫、白茅
dusu: 毒素
danxin: 担心、丹心
buzhi: 不支、不知、不值、不止、不只、不致、不置
bingta: 病榻
danzhuang: 淡妆
chenshan: 衬衫
chuangzi: 窗子
cunluo: 村落
bentian: 本田
gere: 隔热
jique: 既缺
gencha: 跟差
haomai: 号脉
chongzai: 冲在、虫灾
chusan: 初三
dingdong: 叮咚
haobing: 号兵
changfang: 厂方、厂房
huilang: 回廊
chuxian: 初显、出现、出线
dianju: 电锯
chongqi: 充气
dongjing: 动静
heyu: 河鱼
guoban: 过半
hunjue: 昏厥
dasui: 打碎
chongdiao: 冲掉
huaye: 画页
chengxing: 成型、成形、成性、乘兴、逞性、秤星
gouzhu: 钩住、构筑
gengdong: 更动
bukui: 不愧
gongqiao: 拱桥
ganyan: 肝炎
chenshe: 陈设
eshu: 额数
jiaye: 家业
hanwei: 捍卫
jishen: 机身
dengxian: 等闲
bozi: 脖子
genggai: 更该、更改、梗概
buxia: 不暇、不下
aozhou: 熬粥、澳洲
fuye: 副业
huacong: 花丛
jiachan: 家产
huibian: 汇编
fuben: 副本
changyou: 畅游
houtang: 后唐
baokao: 报考
baohuo: 宝货
chuanfu: 船夫
decheng: 得逞
dianzuan: 电钻
bainong: 摆弄
cidian: 疵点、辞典、词典
caiyang: 采样
bogu: 波谷、博古
beilie: 卑劣
fanshen: 翻身、反身
houjun: 后军
chaojia: 超假、吵架
duizhan: 堆栈
benti: 本题、本体
genzhao: 跟着
geyan: 格言
basu: 罢诉
chanza: 搀杂、掺杂
heiqi: 黑漆、黑气
gaihua: 钙化
anma: 鞍马
chucao: 锄草、除草
ganchai: 干柴
biandi: 贬低、遍地
dudao: 督导、读到
haoran: 浩然
diantou: 点头
guibian: 诡辩
chatu: 插图
guojun: 国军
chengxu: 称许、程序
aixiao: 爱小
chenniang: 陈酿
huangshi: 黄石、皇室
emeng: 恶梦
baolu: 暴露
guanzhi: 管制、灌制
gudu: 咕嘟、古都
busui: 不遂
aomiao: 奥妙
chaoshi: 超市、潮湿
chengbai: 成败
bianguan: 边关、贬官
bilou: 鄙陋
hema: 河马
fanghuo: 防火
dadou: 打斗
chuyan: 出演
daiqu: 带去
chouzhao: 抽着、瞅着
chuigua: 垂挂
cefan: 策反
channing: 谗佞
jiazi: 夹子、家资
boda: 博大
daitou: 带头
baishang: 摆上
hezhan: 核战
diulian: 丢脸
dingshu: 定数、订数
chengjiu: 成就
jire: 极热
famang: 法盲
guanzhong: 关中
guali: 挂历
hanqiao: 旱桥
changzhe: 长者
hushuo: 胡说
biqi: 比起、鄙弃、闭气
huishou: 挥手、回收、回手、回首
huanbing: 患病
ganjia: 干架
baiman: 摆满
daliang: 打量
caomang: 草莽
chengji: 成绩、乘机、乘积
chengnian: 成年
bakai: 八开
fengzai: 风灾
boruo: 薄弱
chengchang: 成长
congmin: 聪敏
fengling: 风铃
fengshan: 封山、风扇
feihou: 肥厚
fengli: 锋利、风力、凤梨
guogao: 过高
jiadi: 家底
aoye: 熬夜
bianchi: 贬斥
guci: 骨刺、故此
jitian: 几天
binghao: 冰镐、病号
chuiqing: 垂青
guamian: 挂面
huaxian: 花线
futu: 浮土
chucha: 出差
age: 阿哥
guozao: 过早
fadian: 法典
baosha: 宝刹
ceding: 测定
baixi: 白皙
guohou: 过后
erli: 耳力
dianxing: 典型
duoma: 堕马
geai: 割爱
hunru: 浑如、混入
fengzuan: 风钻
bohai: 渤海
jidao: 击倒
guihua: 鬼话、桂花
jiguan: 机关、籍贯
chongle: 冲了
guowu: 国务
gangzhu: 钢珠
chaichu: 拆除
huami: 花蜜
gouzao: 构造
fengmei: 丰美
douliu: 逗留
banghe: 棒喝
beike: 碑刻、贝壳
chongzhuang: 冲撞
anhe: 暗盒
heile: 黑了
chaoxiang: 潮向
bizi: 鼻子
bijing: 毕竟
houyi: 后裔
huihai: 毁害
dadao: 打倒
bitou: 鼻头、笔头
huaishu: 槐树、坏书
hengmei: 横眉
cangzhou: 沧州
dike: 地壳
banhao: 办好
benxiang: 本相、本想
gejiao: 割胶
diaoyan: 吊唁、调研、调演
deming: 得名
chaixie: 拆卸
biyan: 鼻炎、闭眼
guoguan: 过关
canji: 残疾
gaisuan: 概算
bieju: 别具
fandao: 翻到、反倒、返道
chuangkou: 疮口、窗口
erlun: 耳轮
fangbao: 防暴
beigua: 北瓜
hanren: 喊人、汉人
danxiao: 胆小
caixia: 彩霞
gengrang: 更让
buman: 不满
dipan: 底盘、地盘
fandiao: 反调
chenmo: 沉默
heihan: 黑汉
jiliu: 激流
dingzi: 钉子、锭子
houbian: 后边
feiqi: 废气、废弃
huikou: 回扣
daozha: 道砟
biaoxiang: 表项、表象
jizhou: 几周
eren: 恶人
gengquan: 更全
cangshu: 藏书
biaopan: 表盘
ganyu: 干预、甘于、甘雨
haiyun: 海运
baku: 巴库
fali: 乏力、法理、法力
chajue: 察觉
bixing: 笔形
bianfang: 边防
anfu: 安抚
chenjiu: 陈酒、陈旧
huanjian: 换件
aiyo: 哎哟
huhuan: 呼唤、互换
diaohe: 调和
beitong: 悲痛、悲恸
guanjia: 官价、管家
banpei: 班配
dangzi: 档子
huhua: 胡话
fuqiao: 浮桥
chuangsha: 窗纱
baisao: 拜扫
fansha: 翻砂
duhai: 毒害
fanfang: 反方
bienian: 别念
chiliang: 吃粮
bili: 比例、笔立、笔力、壁立、臂力
diaozao: 雕凿
gebi: 搁笔、戈壁、隔壁
benji: 本纪
daocha: 道岔
huixiao: 回校
gongzhu: 汞柱
chongjing: 崇敬
amei: 阿妹
boguang: 剥光
douzha: 豆渣
hehua: 荷花
adou: 阿斗
housi: 后嗣
huafang: 花房、画舫
beinan: 被难
chuanzhao: 穿着
banzhao: 扳着、板着
choushui: 抽水
jiaza: 夹杂
jiaren: 家人
fengxue: 风雪
aihao: 艾蒿、爱好
huodong: 活动
hanjiao: 喊叫
gelan: 隔栏
gufu: 辜负
biyin: 鼻音
cangyi: 藏医
gushu: 古书
bici: 彼此
dingdang: 叮当
fupin: 副品
jiliang: 几辆、计量
dingju: 鼎举、定居、定局
chuizhi: 垂直
baoye: 报业
banquan: 版权
chucuo: 出错
doudan: 斗胆
ganshu: 甘薯
bideng: 壁灯
citui: 辞退
erbei: 耳背
guanian: 挂念
digua: 地瓜
anjia: 安家
donggong: 动工
gunzhuan: 滚转
huozhe: 或者
gangchang: 钢厂
hencha: 很差
chide: 吃得
bodang: 波荡
hufa: 护法
guhua: 古话、固化
gengwen: 更稳
fengchuan: 风传
banhe: 拌和
duilie: 队列
dongzuo: 动作
jizao: 及早
banzu: 班组
fandong: 翻动、反动
genni: 跟你
erlong: 耳聋
fenyang: 汾阳
huoda: 豁达
guanyu: 关于
diaoyong: 调用
bangshou: 榜首
gaojian: 稿件
chuchun: 初春
chugao: 初稿
hennan: 很难
hainiao: 海鸟
faqi: 法器
dingyue: 订阅
fanyin: 翻印
chengpi: 成批
jirou: 肌肉
hehuan: 和缓
biaoxia: 标下
jilang: 激浪
anhua: 暗花
diaopei: 调配
cansha: 残杀
gongcu: 共促
changan: 长安
caikuang: 采矿
huandian: 换点
bobu: 薄布
gunxiang: 滚向
bushang: 补上、不上
faling: 法令
chaku: 查库
caowu: 草屋
huatong: 话筒
buliang: 不良
hangmo: 航模
cekong: 测控
ganyuan: 甘愿
gouhe: 沟壑
hengfan: 横翻
hangci: 航次
benjiu: 本就
huixiang: 回乡、回想、回响
guju: 故居
bingtun: 并吞
emo: 恶魔
bahe: 巴赫
dezhi: 得知、得志
bawang: 巴望
genzi: 根子
eshou: 扼守
hanfeng: 寒风
huigu: 回顾、惠顾
cier: 刺耳
caotan: 草滩
boduan: 波段
caofang: 槽坊
caomei: 草莓
dongsi: 冻死
chufei: 除非
dongnu: 动怒
huiqi: 毁弃、晦气、秽气
fengchao: 蜂巢、风潮
chuanjie: 串接
huancheng: 环城、换成、换乘
huazhao: 花招、花着
guowen: 过问
faguan: 法官
bajia: 把家
zhaori: 朝日
gongpin: 贡品
diqing: 敌情
hufang: 互访
huohai: 祸害
cunzi: 村子
huanke: 还可
duer: 毒饵
bangbo: 磅礴
fansheng: 反省
hengman: 横蛮
guotang: 果糖、过堂
chuzheng: 出征
doupo: 陡坡
daidao: 带到
chaozhi: 超支、超值
gaimao: 概貌
hezhong: 荷重
caiye: 菜叶
haiyuan: 海员
canliu: 残留
dongkou: 洞口
chicun: 尺寸
fanle: 翻了、反了
feifu: 肺腑
guoying: 国营、过硬
gongxun: 功勋
huilei: 挥泪
fenying: 坟茔
chongying: 充盈
duche: 堵车
huibai: 回拜
jiashen: 家什
jinu: 激怒
fengxiang: 风箱、风向
chengken: 诚恳
changxiao: 畅销
huangsha: 荒沙、黄沙
guoge: 国歌、国格
baoshi: 宝石、报失、报时、暴尸
hongfeng: 洪峰
bushuai: 不衰
coule: 凑了
huoran: 豁然
etuo: 讹脱
dandang: 担当
huahen: 划痕
huaping: 花瓶、画屏
hanjia: 寒假
bingshuo: 并说
buren: 不仁、不忍、不认
aimin: 爱民
bieji: 别急
baichu: 摆出
caoliao: 草料
chutou: 出头、锄头
huangmiu: 荒谬
guazi: 瓜子、褂子
beiwu: 悲呜
chakou: 插口
changjin: 长进
huichao: 回潮
biliang: 鼻梁、比量
guahuan: 寡欢
fengmen: 封门、风门
hupan: 湖畔
fuchu: 浮出
fupiao: 浮漂
fangtan: 访谈
zhaowo: 朝我
fancheng: 泛称
chongman: 充满
benba: 本把
baoren: 报人
bingjin: 并进
beihuo: 北货
chuanpian: 串骗
gaoren: 告人
changjuan: 长卷
benzhu: 笨猪
bairou: 白肉
baichi: 白吃、白痴
biezhi: 别致
guoyun: 国运
citie: 磁铁
beilin: 碑林
faji: 法纪
chuxiao: 初小
fengguang: 风光
dushu: 读书、读数、赌数、度数
bense: 本色
fanmian: 反面
cheli: 撤离
huancong: 还从
cansun: 残损
hunpu: 浑朴
cuncao: 寸草
gupai: 骨牌
baoda: 报答
caimao: 财贸
jimo: 寂寞
chengxia: 城下
buru: 哺乳、补入、不如
guxi: 古稀、股息、固习
feidao: 匪盗
anchu: 暗处
chaoling: 超龄
chengliang: 乘凉
dazi: 打字
banpai: 半拍
daixu: 待续
chenku: 衬裤
duyin: 读音、镀银
fanan: 翻案
danqie: 胆怯
bupin: 补品
coude: 凑得
chaisan: 拆散
guanjie: 关节
baizi: 白子、白字、摆子、稗子
chongyao: 充要、冲要
fanglin: 芳邻
beiguan: 悲观
diaosang: 吊丧
jishui: 积水
diebao: 谍报
huanjie: 环节、换届
feidan: 非但
chuyou: 出油
hansheng: 喊声
gulu: 骨碌
fengwen: 风闻
chengqun: 成群
huidang: 回荡
caozong: 操纵
fanshe: 反射
daide: 逮得
chengba: 称霸
huainan: 淮南
gongzhan: 攻占
anmin: 安民
bahao: 把好
guiguo: 归国、贵国
dunlao: 蹲牢
guoke: 果壳
eba: 恶霸
gangfu: 港府
hanmao: 汗毛
fangan: 反感
ganzhi: 干支
gungun: 滚滚
dingzui: 定罪
huayang: 花样
hujia: 护驾
dizhu: 抵住、地主
huachu: 划出
chouyan: 抽烟
ganshang: 赶上
gongyou: 共有
guoliang: 过量
douchi: 豆豉
fangling: 芳龄
guoce: 国策
changshang: 厂商
dingle: 订了
dixing: 地形
feide: 非得
guangdao: 广岛
bayan: 罢演
huazi: 花子
congcong: 葱葱
huren: 唬人
beicha: 被查
dijia: 底价、地价
baiban: 白班、白版
beizhao: 北朝、背着、被罩
genle: 跟了
chuangpu: 床铺
haifang: 海防
haidao: 海岛、海盗
chuangling: 窗棂
duozhu: 舵主
baodi: 胞弟、宝地
guanyuan: 关员、官员
heishi: 黑市
guangyuan: 广元、广远
ciji: 磁极、刺激
dashan: 搭讪
chaokuan: 超宽
douqing: 豆青
chouzi: 抽资、筹资
geshui: 隔水
guanlu: 灌录
hesheng: 和声
huabo: 划拨
hougong: 后宫
diaozhi: 调制、调治
changbo: 长波
biwen: 逼问
haichao: 海潮
hengshan: 衡山
diwei: 堤围、地委、地位
banchang: 班长、办厂
huzhu: 互助、互祝、户主
huangqi: 黄旗、黄芪
hualang: 画廊
fumo: 抚摸、抚摩、腹膜
biwu: 比武、笔误
cangyu: 藏语
biaotai: 表态
duobi: 躲避
baopi: 报批
chaochan: 超产
hurang: 互让
chediao: 撤掉
huangzhi: 黄纸
guihuan: 归还
erji: 耳机
jiquan: 几圈
jigua: 记挂
baimang: 白忙
baohan: 抱憾
cannue: 残虐
guankou: 关口
jidi: 基地、极低、极地
dahuo: 搭伙
dingdu: 定都
hunpo: 魂魄
baxin: 靶心
dongluan: 动乱
daoding: 到顶、道钉
dengren: 等人
bengfa: 迸发
jixue: 积雪
chuanshen: 船身
chengzan: 称赞
canglao: 苍老
huizhan: 汇展
hongzai: 洪灾
chongta: 冲塌
batou: 把头
gouzi: 钩子
beisai: 杯赛
aihu: 艾虎、爱护
geshou: 割手
huofan: 活泛
biaogong: 表功
jijian: 击键、基建、机件、几件
chongfan: 冲犯
chikui: 吃亏
diaopi: 调皮
chuchan: 出产
dinghuo: 定货、订货
baicu: 白醋
gengxu: 更须
caocong: 草丛
genshang: 跟上
gundong: 滚动
banlai: 搬来
aokang: 澳抗
bifang: 比方
guopi: 果皮
houjing: 后劲、后景
gengneng: 更能
cuixing: 脆性
guba: 古巴
fuji: 腹肌
bizhong: 比重、壁钟
gannan: 甘南
bingwu: 并无
conghui: 聪慧
buliu: 不留
caiyi: 裁衣、才艺
aie: 挨饿
caokou: 草寇
bingshang: 冰上
gunkai: 滚开
duiyou: 队友
couqiao: 凑巧
humian: 湖面、互勉
chishang: 吃上
banlun: 班轮
denghou: 等候
changkuang: 厂矿
fengdu: 封堵、风度
ganfu: 赶赴
changxian: 长线
hanleng: 寒冷
anyu: 按语、暗语、暗喻
gongdi: 功底
huanghun: 黄昏
huicun: 惠存
dishi: 敌视、地势、地市、第十
fangdi: 防地
bantuo: 办妥
chiwan: 吃完
chidao: 持刀、迟到、赤道
chaoxing: 吵醒
beili: 背离、背理、被里
bibu: 臂部
beisong: 北宋、背诵
gongru: 攻入
fanban: 帆板、翻版
beiyin: 背阴
heyuan: 河源
gangyi: 刚毅
huaihua: 坏话
dianhe: 电荷、电贺
heibai: 黑白
chuiguan: 吹管
houqi: 后期
huawei: 划为
cidu: 瓷都
chuanyue: 穿越
cangsheng: 苍生
bashou: 把手、把守、罢手
canzheng: 参政
bujing: 不经、不敬
anjiao: 暗礁
dongfu: 洞府
changgeng: 长庚
hualan: 花篮
jizuo: 基座、极左
huangcao: 荒草
biaoming: 标明、表明
changde: 长得、唱得
chenshi: 趁势
baofeng: 暴风
fukuang: 富矿
benwei: 本位
haitun: 海豚
danhua: 淡化
chuangwei: 床位
bojiu: 薄酒
bolang: 波浪
baibei: 败北
jilai: 寄来
daizai: 呆在、带在
dihuan: 抵还、抵换
huxu: 胡须
huizhi: 回执
dali: 搭理、答理、答礼
andong: 按动
chenhun: 晨昏
fandan: 反弹
hangcheng: 航程
huiqu: 回去
diaonue: 调谑
buli: 不利、不力
huimou: 回眸
chibo: 赤膊
hesuan: 核算
fengsuo: 封锁
bendao: 本岛
boxue: 剥削、博学
caibao: 财宝
daopian: 刀片
gailun: 概论
guaji: 挂机、挂记
banhui: 扳回
fanhao: 番号
chengcai: 成材、成才
bei*: 卑*
chihei: 赤黑
baoxiao: 报销、报晓、报效
biebei: 别被
gengshi: 更是
fanhui: 翻悔、反悔、返回
caijia: 菜价
diaoqing: 调情
fanxiu: 翻修、返修
fanqi: 泛起
dourong: 豆蓉
guoluo: 果洛
gaipian: 该片、钙片
cannong: 蚕农
heni: 和你、河泥
bingdian: 冰点
dongtu: 动土
chousha: 抽纱
fashi: 法师、法式
biren: 逼人、鄙人
gunzi: 棍子
gengyao: 更要
gangkui: 钢盔
jiaxu: 嘉许
hunluan: 昏乱、混乱
baomao: 豹猫
huanyong: 还用
ceping: 测评
huizeng: 回赠、惠赠
caiqu: 采取
chezhi: 撤职
chuanmen: 串门
dingzu: 鼎足
dianneng: 电能
bigan: 笔杆
guanban: 官办
biaozhi: 标志、表侄
bisuan: 鼻酸、笔算
baozuo: 宝座
dengdao: 等到
huandi: 还低
cuanbeng: 蹿蹦
fanbi: 反比
bengdiao: 崩掉
diaosu: 雕塑
baojia: 报价
haogou: 壕沟
diaojie: 调节、调解
gujia: 骨架
diaofu: 调幅
guomu: 国母、过目
henkuai: 很快
haiyang: 海洋
huaxing: 滑行
chengzuo: 称作、乘坐
chutao: 出逃
chidou: 赤豆
bingdao: 冰刀、冰岛、病倒
dianzhong: 点钟
chashui: 茶水
duanjian: 锻件
guazhu: 寡助、挂住
gongdian: 宫殿
baolie: 暴烈
goude: 购得
beizhai: 背债
benmo: 本末
biaobai: 表白
chengfa: 乘法、惩罚
chouhuai: 愁怀
canju: 餐具、残局
dipai: 底牌
houjin: 后进、后晋
fengsao: 风骚
biaode: 标的
jibai: 击败、几百
denghao: 等号
jiaji: 夹击、加急
genjiao: 跟脚
hengqi: 衡器
jiadang: 家当
diyan: 堤堰、敌焰
dianquan: 垫圈
hengxin: 横心
huabai: 花白
huafeng: 话锋
biaochu: 标出
huazhi: 画质
cuomiu: 错谬
bianji: 边际、遍及
budui: 不对
hongda: 洪大、宏大
fanyue: 翻阅
gongchu: 共处
hunzhang: 混帐
diaozhao: 叼着、吊着
cansai: 参赛
chenghu: 称呼
huafu: 画幅
hajie: 蛤蚧
huadong: 滑动、划动
diaojin: 掉进、调进
dongtian: 洞天
gansong: 干松
buci: 不辞
bangwen: 榜文
bidou: 鼻窦
chongchong: 冲冲
huawu: 话务
chachuang: 插床
bingjia: 兵家、病家、病假
jiyu: 基于、机遇、积郁、寄予、寄语、寄寓、际遇
huaqi: 花期
hanchao: 寒潮
fanlan: 泛滥
baofei: 报废
bixie: 避邪
dulun: 渡轮
guoming: 国名
ganchang: 肝肠
ganfan: 干饭
danwu: 耽误
dannang: 胆囊
chouchu: 抽出、抽搐、踌躇、愁楚
houmian: 后面
duoshan: 躲闪
diantong: 电筒
benneng: 本能
guangxiu: 广绣
baifan: 白矾
hunshen: 浑身
haili: 海里
dongzui: 动嘴
bengai: 本该
babiao: 靶标
guage: 瓜葛
gazhi: 嘎吱
diangu: 典故
banyin: 半音
bailing: 白领
buxie: 补写、补血、不懈、不屑
daiman: 怠慢
ancha: 安插、按插
bianfeng: 边锋
huidui: 汇兑
chawen: 查问
handong: 涵洞、寒冬、撼动
jichu: 基础、寄出
aojian: 熬煎
choumen: 愁闷
chuchuang: 初创、橱窗
fawei: 乏味
chuhu: 出乎
chalou: 茶楼
bojiang: 播讲
fengpian: 封片
jiabei: 加倍
gouhua: 钩花、构画
chaozhong: 超重
gaosu: 告诉
chuye: 初夜、除夜
hanshui: 汗水
dongxue: 洞穴
guhui: 骨灰
houri: 后日
boqi: 勃起
jiqun: 机群
bannian: 半年
cibei: 慈悲
chexia: 撤下
haixiang: 海象
chenci: 趁此
dizhi: 抵制、地址、地质
cadiao: 擦掉
houshe: 喉舌
gengde: 更得
fushi: 服食、服式、服侍、服饰、腐尸、腐蚀、副食
guowei: 国威
bancheng: 办成
haihuo: 海货
chuankong: 穿孔
guanhao: 管好
eqi: 恶气
chuifeng: 吹风
heci: 贺词
fengmian: 封面
ganhuo: 干活、干货、肝火
gusui: 骨髓
fengliang: 风凉、风量
biaoge: 表哥、表格
hedao: 河道
chongdan: 冲淡
bizhen: 逼真
chuanzhu: 串珠
jiatou: 夹头
daqiu: 打球
aniang: 阿娘
bihu: 庇护、壁虎
chaqu: 插曲
boluo: 剥落、菠萝
jijie: 几届、季节
henshao: 很少
bugou: 不苟、不够
jida: 击打、极大、即达
chuangjing: 闯劲
chongluan: 虫卵
buning: 不佞
huapu: 花圃
feili: 非礼、肥力
guimi: 诡秘
eqian: 额前
hanwang: 汉王
dedao: 得到
baoluan: 暴乱
chazuo: 插座
bujiang: 不讲
gaibei: 该被
anbiao: 岸标
fenjiu: 汾酒
cedong: 策动
binyu: 濒于、宾语
hushi: 虎势、护士
chikou: 茬口
duwang: 赌王
diaojiao: 调教
beijing: 北京、背景
huangnan: 黄南
jixin: 寄信
ala: 阿拉
bimao: 鼻毛
chabo: 插播
hegan: 喝干
couhe: 凑合
caihui: 才会、财会、彩绘
fangding: 房顶
gongxiang: 共享
chengxi: 城西
beishu: 背书
binghai: 病害
bingshu: 兵书
caijue: 裁决、采掘
feixiao: 肥效
dongdang: 动荡
chengpin: 成品
huowei: 或为
deshu: 得数
gancai: 干才、干菜
guibiao: 圭表
huangdang: 晃荡
dailu: 带路
chuantou: 穿透
chuibei: 捶背
ezhuo: 恶浊
daban: 搭班、打扮
ganlian: 干连、干练
fanxin: 翻新、凡心
guozhen: 果真
gege: 格格
bihui: 笔会、闭会、避讳
aixin: 爱心
decai: 德才
haishi: 海狮、海事
cuiyu: 翠玉
chuangjin: 闯进
cuanfan: 窜犯
guonei: 国内
chengran: 诚然
hainan: 海难
dongxin: 动心
huandai: 换代
canguan: 餐馆、参观
chuanxian: 船舷、串线
canglan: 藏蓝
dunwei: 吨位
chezou: 撤走
huhang: 护航
henduan: 很短
cachu: 擦除
hande: 喊得
hongzhong: 洪钟
cancu: 蚕蔟
goujia: 构架
huiquan: 挥拳
anshui: 氨水、安睡
cixing: 磁性、辞行、词性
dutu: 赌徒
gouhuo: 苟活、购货
banjie: 板结、半截
dingning: 叮咛
gaowei: 告慰
bingku: 冰库
guanyi: 冠以
huixu: 回叙
chaoju: 潮剧
huadan: 花旦
baipao: 白跑
bazi: 靶子
daixiang: 带向
diyi: 敌意、地衣、第一
heima: 黑马
dalian: 搭裢
duidie: 堆叠
fanzhi: 反之
bianjiang: 边疆
fading: 法定
dikou: 敌寇
gengzhen: 更臻
guiren: 贵人
daoting: 到庭
huamei: 画眉
hunyou: 荤油
banya: 板鸭
cinian: 次年
aiya: 哎呀
danchen: 诞辰
chuiqi: 吹起
huaxiao: 花销
hewang: 河网
hengbao: 横暴
dingzai: 钉在、定在
erlai: 二来
banhua: 版画
dingdian: 定点
hunhei: 昏黑
bingqie: 并且
jiri: 吉日、即日
jixiang: 吉祥、极想、几项
bujuan: 不倦
bixi: 鼻息
zhaoting: 朝廷、朝庭
gouan: 苟安
bieli: 别离
beijiang: 北疆
fankao: 反铐
feibu: 肺部
huanghou: 皇后
chuyi: 初一
huinian: 回念
dongjiao: 动脚
diaochu: 调出、调处
bailin: 白磷、柏林
gongneng: 功能
daocao: 稻草
antai: 安泰
changshan: 长衫
benshuai: 本帅
guixiao: 贵校
huale: 花了、画了、划了
daijing: 带劲
changtu: 长途
guanjian: 关键
chengchi: 城池
aici: 挨次
heji: 核计
guadiao: 刮掉
daishang: 戴上、带上
banwan: 办完
dichan: 地产
guangda: 广大
doushi: 斗士、斗室、陡势
guangfan: 广泛
bowen: 波纹
changpao: 长袍、长跑
caoping: 草坪
jiabin: 嘉宾
heiti: 黑体
chuzu: 出租
anzang: 安葬
baihou: 白喉
huadao: 滑倒、滑到、滑道
baiti: 白体
hezhao: 喝着
dousheng: 斗升
fuyin: 福音
dianling: 电铃
fangxin: 芳心
diudiao: 丢掉
buban: 补办
dianran: 点燃、点染
beizhe: 被这
biandan: 扁担
cimu: 慈母、刺目
choucuo: 筹措
jishang: 击伤、机上、寄上
bingbian: 兵变、病变
huaihe: 淮河
dunhuo: 囤货
heyi: 和易、和议
huohuo: 活活
bamai: 把脉
bingzao: 病灶
huiwu: 挥舞、回屋
chulie: 出列
chengyu: 成语
bazhi: 罢职
chaoyong: 潮涌
churen: 出任
daidong: 带动
genji: 根基
baogang: 宝钢
dasi: 打死
cuihuo: 淬火
bainian: 拜年
aizeng: 爱憎
jituo: 寄托
huanxiao: 还小
ershen: 二审
chongguo: 冲过
hankou: 汉口
baitiao: 白条
fengbo: 风波
huanmang: 还忙
danwang: 淡忘
banzou: 搬走
hengpai: 横排
jiahou: 加厚
candou: 蚕豆
chixin: 痴心
guanai: 关爱
fanxiao: 返销、返校
baitong: 白铜
ganba: 干吧
edou: 恶斗
dude: 都得
buhuo: 捕获、不惑
cijiao: 赐教
chongwu: 宠物
hongmao: 鸿毛
baodong: 暴动
diuzai: 丢在
ditou: 地头
beiwen: 碑文
feijiu: 废旧
duojiao: 跺脚
changduan: 长短
feishi: 肥实
huashang: 花上、画上、划伤
huangse: 黄色
fenfu: 吩咐
huitian: 回填
anmi: 安谧
hejian: 核减
baiyang: 白羊、白养
dieru: 跌入
fangkong: 防空
jiqi: 机器、激起、吉期、极其、及其
heqi: 喝起、和棋、和气
duban: 督办
baie: 白鹅、白垩
bingjing: 冰晶、并经
haitan: 海滩
fangfan: 防范
biekan: 别看
dianxin: 点心、电信
chaoliang: 超量
gelie: 割裂
huanshou: 还手
banfu: 板斧
genghe: 更合
huazhan: 花展、画展
duxi: 都系
diaoting: 调停
jike: 极可、即可、即刻、既可
gongxian: 贡献
bingzheng: 秉正、病征、病症
gangqiang: 刚强、钢枪
gentou: 跟头
dijiu: 第九
duneng: 都能
cizhuan: 瓷砖
dengdeng: 等等
coucheng: 凑成
beikou: 被扣
gupi: 鼓皮
baifu: 拜服
guanli: 官吏、管理、贯例
dizuo: 底座
chuanchang: 船长、船厂
daluan: 打乱
duifang: 堆放
chengchu: 惩处
dongdan: 动弹
bopi: 剥皮
bingshi: 兵士、冰释、病史、病逝、病势、病室、并是
bixin: 笔心
chengdui: 成堆
huangao: 还高
fanshi: 凡事、凡是
duji: 毒剂、毒计、赌技
duqi: 毒气、赌气、肚脐
diaodui: 掉队
caotu: 草图
huadeng: 花灯
hecai: 喝彩
fanmei: 凡没
gengxin: 更新
fuan: 福安
chuansuo: 穿梭
guodong: 过冬
babing: 把柄
diannao: 电脑
chijin: 吃紧、吃进、赤金
daiji: 待机
bingyu: 病愈、并于
chengmen: 城门
fanjing: 返京
huidong: 挥动
geban: 隔板
huiche: 回车
huaxue: 滑雪
chenlun: 沉伦
cangmin: 藏民
aidao: 挨到
chongtian: 充填、冲天
biaolu: 表露
diaogua: 吊挂
buwei: 不惟、不为、不畏、不谓
huimo: 徽墨
haizhan: 海战
henneng: 很能
fengyong: 蜂拥
bima: 蓖麻
chiwu: 迟误
benzhao: 本着
hanzi: 汗渍、汉子、汉字
chuanbu: 船埠
baole: 抱了、报了
diaoman: 刁蛮
duge: 镀铬
buzi: 不赀、簿子
dunjue: 顿觉
hecha: 喝茶、核查
binlin: 濒临
dinghu: 订户
fanshui: 反水
diandao: 颠倒
chenzui: 沉醉
diaoxiang: 雕像、调向
hulang: 虎狼
huhui: 互惠
huayin: 滑音、话音
chuangbian: 床边
fuyan: 敷衍、赴宴、附言
daiming: 待命
hengtang: 横躺
buzhong: 不中
cagan: 擦干
biaoqian: 标签
hunxing: 荤腥
chonghao: 充好
dating: 打听
buxiu: 不休、不朽
aijin: 挨近
hungu: 浑古
fengyun: 风云、风韵
changman: 长满
binghe: 冰河、并和、并合
buyi: 补衣、补遗、补益、不一、不依、不宜、不已、不易、不意、不义
gaozi: 篙子、稿子
jiacu: 加粗、加醋
guoqi: 国旗、国企、过期
guoshu: 国书、国术、果树
ganbei: 干杯、干贝
heshun: 和顺
huangniu: 黄牛
gongyi: 共议
congjiang: 葱姜
dongguo: 动过
huomai: 活埋
beizhi: 碑志、卑职
dasuan: 打算
fangwu: 房屋、防务
banqi: 班期、扳起
buhao: 不好
gengti: 更替
daoshen: 刀身
chuizi: 锤子
bendan: 笨蛋
chaoluo: 潮落
houlai: 后来
daopao: 道袍
banjing: 半径
gunbian: 滚边
guore: 过热
doufeng: 兜风
jiben: 基本、疾奔、几本
chouda: 抽打
ganjin: 赶紧
daan: 答案
gongye: 功业、汞液
hangyun: 航运
caineng: 才能
canben: 残本
chuandou: 川豆
cunchang: 村长
gaidian: 该店
guangyi: 广义
daiye: 待业
caihao: 才好、彩号
heling: 喝令
hunza: 混杂
fenghuang: 凤凰
chongfeng: 冲锋
guobang: 过磅
hutou: 户头
baitou: 白头
biduan: 笔端
douya: 豆芽
fujia: 富家、附加
feinan: 非难
douran: 陡然
gangwan: 港湾
beiyi: 被疑
guanlian: 关联
doujun: 陡峻
henian: 贺年
chiguang: 吃光
daodi: 到底、道地
chongxi: 冲喜、冲洗
baoxiang: 报箱
enze: 恩泽
guoli: 国立、国力
haikou: 海口
cuowei: 错位
biesan: 瘪三
hainei: 海内
fendi: 坟地
diqiu: 地球
huamu: 花木
jinan: 极难、济南
huanghe: 黄河
houyu: 后语
gerang: 割让
fengshui: 风水
beidai: 背带
guadao: 刮刀
huapen: 花盆
fengle: 疯了
diandeng: 点灯、电灯
aiyu: 碍于
huanzao: 还早
guodang: 过当
botao: 波涛
chenjin: 沉浸
fengkou: 封口、风口
baidong: 摆动
fanteng: 翻腾
guoyou: 国优、国有
genghao: 更好
chima: 尺码
bofang: 播放
couji: 凑集
baisheng: 白生
aoyao: 熬药
gongdu: 攻读、共度
dingxiang: 定向
chuangdian: 床垫
hunji: 混迹
benci: 本次
chachu: 查出、查处
gule: 鼓乐
bugui: 不轨
jiadian: 家电、加点、加垫
bujie: 不解
ezhi: 扼制、遏止、遏制
jiawu: 家务
cantian: 参天
dianmian: 店面
guixi: 归西
beifu: 背负、被俘、被服
buxian: 不限
dongjie: 冻结
dudu: 都督
baozi: 胞子、豹子
hufeng: 胡蜂
houyou: 后又
ganshi: 干湿、干事
duyi: 都已、都以
haojiao: 嚎叫、号角、号叫
fajia: 法家
jiti: 机体、肌体
dajie: 搭界
chencu: 陈醋
cigu: 慈姑、刺骨
fengqing: 风情
danda: 胆大
beidou: 北斗、背篼
baoyang: 抱养
gouxiao: 购销
ganmei: 甘美
fengye: 枫叶
hubei: 湖北
haidai: 海带
huanghua: 黄花、谎话
hepan: 河畔
dianjia: 店家
dakai: 打开
duzhao: 读着
houchuang: 后窗
chuanyi: 穿衣
huaqiao: 花俏
funei: 府内
bande: 办得
chazi: 查字
hongyuan: 宏远
changyi: 肠衣、厂医
faner: 反而
erguang: 耳光
genwo: 跟我
aibian: 挨边、癌变
fandu: 贩毒
genjiu: 根究
churang: 出让
bamian: 罢免
dukang: 杜康
chenjiang: 沉降
houma: 后妈
baoqing: 报请
bugei: 补给、不给
guozi: 锅子、果子
zhaota: 朝他、朝它、朝她
danguan: 胆管
biaogan: 标杆
genyuan: 根源
hujing: 虎劲、互敬
biaohao: 标号
hechuang: 河床
baoying: 报应
zhaoyou: 朝右
jiaxiao: 家小
dechu: 得出
guanqie: 关切
gugu: 股骨
ansheng: 安生
duhe: 渡河
gengming: 更名
fumin: 富民
chuxun: 初旬、出巡
chongdao: 冲倒、冲到
gengxiao: 更小
dangguo: 荡过
bingqu: 病区
gongxi: 恭喜
busha: 捕杀
duiwu: 队伍
huani: 花呢、滑腻
aimei: 爱美
chejun: 撤军
caobao: 草包
cicheng: 辞呈
gangchuang: 钢窗
gongfeng: 贡奉
fale: 罚了
fanghuan: 防患
diangao: 电告
gaofei: 稿费
chaguan: 茶馆
aicao: 艾草
huitou: 回头
huanzai: 还在
fachang: 法场
caoqi: 操起
feishui: 肥水、废水、沸水
chuaimo: 揣摸、揣摩
gangman: 刚满
houyang: 后仰
baike: 拜客
chaoma: 吵骂
benzhen: 本镇
beige: 悲歌
fengshu: 枫树
fuxie: 腹泻
huanqing: 还清
dingzuo: 定做
eryou: 而又
afu: 阿附
hexie: 和谐
baodan: 报单
cashi: 擦拭
caihong: 彩虹
houjiao: 吼叫、后脚
huiling: 回令
banhu: 板胡
haqian: 哈欠
guaduan: 挂断
guabiao: 挂表
benshen: 本身
anniu: 按钮
banwu: 班务
jiafeng: 夹缝、加封
buwen: 不稳、不问
bengjian: 迸溅
huihao: 挥毫
caicong: 才从
guti: 固体
gongmian: 共勉
diqu: 地区
gangquan: 钢圈
chonglang: 冲浪
bingneng: 并能
chouxiang: 抽象
butong: 不通、不同
beihou: 背后
bihun: 逼婚
jijiang: 即将
hanrong: 涵容
chouqian: 抽签
douhao: 逗号
guanchuan: 贯穿、贯串
beixia: 卑下、背下
guoren: 国人、果仁、过人
hehao: 和好
bingjiang: 兵将、并将
dingli: 鼎立、鼎力、定理、订立
bomo: 薄膜
diaosi: 吊死
cunxin: 寸心
dandong: 丹东
chaoguo: 超过
falao: 法老
gehai: 隔海
guafang: 挂放
baishou: 摆手、拜寿
huiguo: 回锅、回国、回过
erduo: 耳朵
huanshuo: 还说
chengyuan: 成员
caihua: 才华、菜花
huanle: 换了、患了
erhu: 二胡
fengtou: 风头
huankuai: 还快
huanli: 还礼
fanzhuan: 翻转、反转
huozai: 活在
chouzou: 抽走
bangyang: 榜样
huansan: 涣散
cihua: 磁化、刺花
fengzhu: 封住
jigei: 寄给
chaiguo: 拆过
genglan: 更阑
fengche: 风车
huanliu: 环流
apo: 阿婆
bajiao: 芭蕉、八角
ganrao: 干扰
chenlie: 陈列
baiye: 拜谒
chiqia: 吃卡
hanjin: 寒噤、汗巾
daxiao: 打消
buque: 补缺、不缺
dazhan: 打颤
jiazu: 家族
choudan: 臭蛋
chuqiu: 初秋
baizai: 摆在
chuitui: 捶腿
chenta: 趁他
bangqiu: 棒球
fengshuo: 丰硕
chukou: 出口
anying: 安营
gunbei: 滚杯
chuikai: 吹开
caobian: 草编
ershou: 二手
ducha: 督察
guakao: 挂靠
bingren: 病人
ganshuang: 干爽
duihao: 堆好
gaidang: 该当
boqing: 薄情
chanzi: 铲子
caixin: 菜心
aizhao: 挨着
huoluo: 活络
haipa: 害怕
bayue: 八月
huluan: 胡乱
huozhao: 活着
jiada: 加大
baoyuan: 抱怨
dasao: 打扫
huibi: 回避
fenglei: 风雷
dongmai: 动脉
jixiu: 机修
beipo: 被迫
beiai: 悲哀
fagui: 法规
chahua: 插花、插画、插话、茶花
hongqi: 宏碁
canzhi: 残肢
butuo: 不妥
dianliao: 电疗
dianqiu: 点球
duwei: 都为
danbao: 担保
heidong: 黑洞
cuoza: 错杂
bofeng: 波峰
dale: 搭了、打了
guiqiao: 归侨
ganjing: 干劲、干警、干净
zhaobei: 朝北
fangfu: 防腐
daidu: 歹毒
fuchen: 浮尘、浮沉
buting: 不听、不停
aihe: 爱河
biaogai: 表盖
fanghan: 防寒
erni: 而你
chaifang: 拆房
hanghai: 航海
gouqie: 苟且
hupi: 虎皮
fengwang: 蜂王
chuanpeng: 船篷
dianfan: 典范
jishi: 基石、及时、疾驶、即时、即使、即是、几十、几时、几室、技师、济世、济事、记事、既是
huaji: 滑稽
chaofan: 超凡
gaofa: 告发
handan: 邯郸
bozhe: 波折、波磔
guoshou: 国手
chouti: 抽屉
cuopan: 错判
dingdiao: 定调
erwo: 而我
chenfu: 沉浮、陈腐
huise: 晦涩
bingpi: 兵痞
fengtu: 风土
fengrun: 丰润
digong: 地宫
jiagu: 加固
diannei: 殿内
gezha: 隔栅
chaoxun: 潮汛
hunchong: 混充
canjun: 参军
chengzhen: 城镇
bingju: 病句、并举
baiqi: 白漆、白旗
jimou: 机谋、计谋
caolv: 草率、草绿
haigu: 骸骨
daying: 答应
changshou: 长寿
biansai: 边塞
jizi: 寄自
jiwang: 寄往、既往
chuaixiang: 揣想
hezhun: 核准
chaimai: 拆卖
baojie: 胞姐、报捷、报界
baoli: 暴利、暴力、暴戾
huihe: 回合、汇合
an*: 暗*
genggao: 更高
bijian: 比肩、鄙见
caina: 采纳
gunqu: 滚去
ganlan: 甘蓝
caiwu: 财物、财务
changtian: 长天
diji: 敌机、地基
huanjia: 还价
fangbei: 防备
danfu: 担负
bingzai: 并在
guiyi: 诡异
heran: 赫然
dimao: 地貌
benling: 本领
huibao: 回报、汇报
huaidan: 坏蛋
heju: 和局
danjiao: 旦角
beidiao: 贝雕
chuanchuan: 串串
feihua: 废话
guaqu: 刮去
jiluo: 击落
chengtao: 成套
bimian: 避免
fengmi: 蜂蜜、风靡
chongxing: 宠幸
canfei: 残匪、残废
caoren: 草人
fengtian: 丰田
fenghao: 风镐
feidian: 沸点
dutai: 赌台
bukan: 不堪、不看
chugong: 出工
gangcong: 刚从
geqiang: 隔墙
huhan: 呼喊
biaoben: 标本
chuse: 出色
gangzheng: 刚正
beiren: 背人、被人
houfang: 后方
caipu: 菜谱
huangjiu: 黄酒
erxian: 而显
cetan: 测探
diban: 底板、地板
benwen: 本文
buyu: 捕鱼、哺育、补语、不虞、不予、不与
anman: 安曼
dianzha: 电闸
houshan: 后山
ernv: 儿女
chentuo: 衬托
gancao: 干草、甘草
guili: 瑰丽
baogui: 宝贵
fangmei: 防霉、访美
daobei: 刀背
huchu: 呼出
gengding: 更定
genjing: 根茎
chengqiang: 城墙、逞强
changsun: 长孙
fangwen: 访问
choukuan: 筹款
chudiao: 除掉
guochang: 过场
chenli: 衬里
huaxu: 花絮
datong: 打通
budi: 不低、不敌
ciliao: 磁疗
dongrong: 动容
genggei: 更给
huixuan: 回旋、贿选
duotai: 堕胎
dengta: 等他、等她
baiping: 摆平
huanshui: 环水
daqiao: 搭桥
doudi: 兜底、抖底
dongzhe: 动辄
danxi: 旦夕
fuyao: 服药
guapian: 瓜片
guinv: 闺女
huaizhang: 坏帐
geshan: 隔山
enqing: 恩情
duzhe: 读者
guchui: 鼓吹
cesuan: 测算
chuhang: 出航
chengpan: 秤盘
couge: 凑个
fangchao: 防潮
chujie: 出界
dengyan: 瞪眼
fangnei: 房内
hanchu: 喊出
hanyang: 涵养
bianqu: 边区
bimo: 笔墨
chaochang: 超常、超长
bushen: 补肾、不深、不慎
chouhua: 筹划
caoyan: 操演
guazai: 挂在
chaiqian: 拆迁
ceshi: 测试
anxie: 安歇
dingyuan: 定员
feimei: 肥美
chuhai: 出海、除害
huaxia: 滑下、话匣
jizhang: 击掌、记帐
huidian: 回电
haile: 害了
chenmei: 沉没
gaochui: 告吹
baizhen: 败阵
gezhi: 搁置、胳肢、革职
caipan: 裁判
bingfen: 兵分
chongshi: 充实
dupan: 读盘
heta: 和他、和她
bailuo: 败落
heihe: 黑河
cuozi: 错字
bisai: 鼻塞、比赛、闭塞
buzhun: 不准
huabian: 花边、哗变
chengse: 成色
bunan: 不难
canshu: 参数
fumie: 覆灭
hedui: 核对
chengquan: 成全
guli: 鼓励、故里
hutui: 护腿
bingyong: 并用
chijiu: 持久
doupai: 斗牌
fansi: 反思、贩私
dadiao: 打掉
hailiang: 海量
hetao: 核桃、河套
ganquan: 甘泉
huading: 划定
gande: 干得
chesu: 撤诉
diangua: 电挂
huoming: 活命
gangkou: 港口
gengruo: 更弱
huoyi: 获益
hexin: 核心、贺信
diaodeng: 吊灯
andun: 安顿
jiwu: 既无
biehao: 别号
bale: 罢了
beidao: 悲悼、被盗
ciliu: 刺溜
guandong: 关东
feizhuang: 肥壮
guyou: 故友、固有
fengzi: 风姿、疯子
cuanguo: 篡国
fuyi: 服役
gediao: 割掉、格调
jigu: 击鼓
beini: 被你
chongru: 冲入
huashi: 花式、花饰、花市、滑石、画师、画室
chentou: 衬头
bingjiao: 冰窖
chongsha: 冲杀
chougan: 抽干
guigong: 归公
bengle: 崩了
chicu: 吃醋
houying: 后影
chulu: 初露、出炉、出路
caike: 才可
cuojue: 错觉
baolan: 宝蓝
chongxiao: 冲销
caizhao: 彩照
chuping: 初评
cixu: 次序
chuguo: 出锅、出国、楚国
daofa: 刀法
daowo: 到我
biaoshu: 标书
guanyin: 官瘾
boyin: 播音、波音
feiyi: 菲仪、非议
dedang: 得当
anmei: 暗昧
huanglian: 黄连
changnv: 长女
daoqiao: 刀鞘
ducong: 都从
fanguan: 反观
huachi: 话茬
hangzhou: 杭州
chengdu: 成都、程度
heiye: 黑夜
beifen: 悲愤、辈分
huagui: 划归
dianchang: 电厂
guatou: 寡头
bingzhui: 冰锥
hanbao: 汉堡
huangpu: 黄埔
caoyao: 草药
doujia: 豆荚
anda: 安达
bieyang: 别样
chafeng: 查封
baosang: 报丧
guojie: 国界、过节
deba: 得把
benguo: 本国
henji: 痕迹、痕记
enian: 恶念
huihua: 回话
ansuan: 暗算
changbei: 长辈
bianxing: 扁形
aiyan: 碍眼
benzu: 本族、本组
gangao: 港澳
feishou: 匪首
caiduo: 裁夺
fengdong: 封冻、风洞
chongli: 冲力
gunzhu: 滚珠
jiyao: 机要、既要
guaqian: 挂牵、挂欠
canbai: 参拜、残败
hengxing: 横行
feidu: 非独
huoxiang: 活像
fengjin: 封禁
bendi: 本地
chongpei: 充沛
chaochu: 超出
hengbiao: 横标
dajiu: 搭救
chuanqiong: 川芎
benshu: 本书
huanneng: 还能
dunjiao: 钝角
huanbu: 还不
henduo: 很多
doubi: 陡壁
bantian: 半天
hejie: 和解
dianguang: 电光
dianbi: 电笔
goufang: 购房
baoshen: 报审
eguo: 恶果
jibian: 畸变、即便
chengui: 陈规
bucuo: 不错
cuoci: 措辞、措词
beiwo: 被窝、被我、被卧
huangyin: 荒淫
diaoli: 调离、调理
huidan: 回单
chiguo: 吃过
guanming: 冠名
diaogeng: 调羹
huodao: 活到
gongming: 功名、共鸣
guandiao: 关掉
haozi: 号子
douke: 豆壳
huanji: 还击、还急、换季
zhaozhao: 朝着
dongwu: 动武、动物
duxun: 毒蕈
egun: 恶棍
guolv: 过虑、过滤
guiguai: 诡怪
huannan: 还难、患难
baiguang: 白光
dingjing: 定睛
feirou: 肥肉
cizhen: 刺针
beifang: 北方
chaoqun: 超群
diaoxi: 调戏
diaoya: 掉牙
daxiang: 打响
gouwu: 购物
jidang: 激荡、既当
hongren: 哄人
erhuan: 耳环
ganbing: 干冰
huojiu: 获救
cougou: 凑够
guoku: 国库
huapan: 花盘
fanggai: 房改
ciru: 刺入
exin: 恶心
gengke: 更可
gancui: 干脆
diaokong: 调控
baobao: 宝宝
guojiang: 果酱、过江、过奖
fuzai: 附在
bushan: 不擅、不善
hefu: 和服
gecao: 割草
enyuan: 恩怨
guiji: 鬼计、诡计
chouqi: 抽气、抽泣、臭气
canrong: 参茸
chengchuan: 乘船
didian: 地点
ganlie: 干裂
fengpi: 封皮
jiding: 极顶、既定
benqian: 本钱
capi: 擦皮
huchi: 护持
huiluo: 回落
fangdao: 防盗
gangting: 岗亭
dingshao: 盯梢
chaozai: 超载
dati: 答题
diaokan: 调侃
changxi: 唱戏
huabie: 话别
angfen: 昂奋
dongren: 动人
hanyan: 汗颜
churu: 出入
guagong: 刮宫
anri: 按日
fubai: 腐败
duzhong: 肚中
banbai: 半百
duangong: 锻工
buchang: 补偿、不常、不长、不畅
baozhu: 抱住
haowai: 号外
baizhang: 败仗
huanggong: 皇宫
hekou: 河口
fancha: 反差
fangzhu: 防蛀
hean: 河岸
huanrang: 还让
gengsi: 梗死
hehui: 和会
dingyang: 定洋
gaisi: 该死
hanshi: 汉室
chengtian: 成天
chuangxia: 床下、闯下
chaxun: 查询、查寻
guhuo: 蛊惑
houdao: 吼道、后到
duqian: 赌钱
caideng: 彩灯
jijing: 机井、机警、即景、几经、寂静
chuanyin: 串音
ganhao: 干嚎、干号
bilv: 比率、碧绿
handai: 寒带、汉代
huandao: 环岛
bingkuai: 冰块
dikang: 抵抗
fengchui: 风吹
boran: 勃然
diaotong: 吊桶
guomao: 国贸
fangao: 凡高
guaiguo: 拐过
cangzu: 藏族
biegu: 瘪谷
goujian: 构件
donghua: 动画
gonghe: 恭贺、共和
guobao: 国宝
duzhou: 赌咒
guixiong: 鬼雄
gengqing: 更轻
huashu: 花束
jixia: 几下、记下
chuma: 出马
falang: 法郎、珐琅
goubian: 钩边
dingren: 盯人、定人
dailing: 带领
huaduo: 花朵
dazhang: 打仗
benye: 本页
guoyu: 国语、过于
cunwai: 村外
dianchu: 掂出、点出
dekui: 得亏
dieyong: 蝶泳
guwu: 鼓舞、古物
bishao: 比绍
choumi: 稠密
chenbian: 趁便
houwei: 后卫
huaguan: 花冠
biechu: 别处
chuancai: 川菜
beizhuang: 悲壮
anliang: 按量
daoxing: 道行
beiqu: 北曲
chetui: 撤退
gangshui: 钢水
cizhong: 刺中
jicang: 机舱
fenwei: 氛围
changsha: 长沙
fushang: 府上、富商、附上
bumou: 不谋
guiguan: 桂冠
cili: 磁力
hongshui: 洪水
ganjie: 干结
huangdan: 荒诞、黄疸
cefeng: 册封
dabang: 搭帮
baikan: 白看
cangtian: 苍天
guzu: 鼓足
jineng: 机能、技能、既能
buguan: 不关、不管
henxiao: 很小
biaoti: 标题
beitan: 悲叹
dongding: 洞顶
baoguan: 报关、报馆
donghuai: 冻坏
diaobo: 调拨
jijia: 基价、机架、几家、几架
duosuo: 哆嗦
bieshi: 别是
baiwang: 拜望
gaizhan: 该站
huizu: 回族
etou: 额头
diejia: 跌价
bingle: 病了
gantu: 干土
hanchuang: 寒窗
caishui: 财税、踩水
fengsu: 风俗、风速
huyan: 胡言
doushua: 逗耍
chuilian: 锤炼
chengyi: 成衣、诚意
haimen: 海门
chengdong: 城东
dizu: 地租
guian: 归案
esheng: 恶声
fangxian: 防线
gangtai: 港台
bantou: 班头、扳头
daoxi: 蹈袭、道喜
guaijiao: 拐角
zhaowai: 朝外
diaogan: 钓竿
gaozhong: 告终
dongyao: 动摇
diaopin: 调频
gengchang: 更长
dengwo: 等我
bishu: 避暑
dongwai: 洞外
anya: 按压
caimi: 采蜜
feida: 肥大
canchuan: 残喘
dianhu: 电弧
aizhong: 爱重
chenlu: 晨露
bala: 疤瘌
furu: 腐乳
fuhui: 赴会、附会
dipi: 地皮、地痞
ganju: 甘居、柑橘
gangbi: 钢笔、港币
cundui: 村队
dundao: 钝刀
chaozui: 吵嘴
aipeng: 艾蓬
dongshang: 冻伤
gengzao: 更糟
daojian: 刀尖
cuozhi: 措置
chuzhen: 出诊、出阵
gangshao: 岗哨
chaopiao: 钞票
huajiao: 花椒、花轿
eding: 额定
binjiang: 滨江
fanzai: 凡在
guosheng: 过剩
guofa: 国法
huagan: 滑竿
diba: 堤坝、第八
banshou: 扳手
faguo: 法国
bulao: 捕捞
beiou: 北欧
chujiao: 初交
chongren: 充任
hanhua: 喊话、汉化
huangli: 黄鹂、皇历
hunling: 魂灵
hougen: 后跟
chadao: 茶道
huaile: 坏了
baozhao: 抱着
buchi: 不齿、不啻
jibu: 极不、疾步、几部、既不
huian: 晦暗
baijiang: 白讲、败将
daoba: 刀把
boyi: 薄衣
fangdan: 防弹
dianwen: 电文
gujiu: 古旧
guinei: 柜内
henzhong: 很重
dungou: 盾构
ganchu: 干出、赶出
guixiu: 闺秀
chaodao: 吵到
guomen: 国门、过门
cuizhe: 摧折
diaofang: 调防
chugui: 出轨、橱柜
bianlu: 边路
chenxiang: 沉箱
chuiluan: 吹乱
daotian: 稻田
gaoben: 稿本
chiluo: 赤裸
jiacan: 家蚕
anwen: 安稳
banlu: 半路
chaotuo: 超脱
bingzhen: 冰镇
hangtian: 航天
dele: 得了
chanong: 茶农
duanlian: 锻炼
cuole: 错了
benxian: 本县
baoshou: 暴收
daihui: 带回
huiyan: 慧眼、汇演、讳言
chaji: 茶几、查缉
banban: 斑斑、办班
fangyi: 防疫
jiyan: 吉言
gemai: 割麦
duokou: 垛口
cangpin: 藏品
huoye: 活页
dengshi: 等式
gongli: 功利、功力
diaoyu: 钓鱼
huanxiang: 还乡、还想、还向
dianzhui: 点缀
dihou: 敌后
gualv: 挂虑
baifo: 拜佛
biaotu: 标图、表土
funan: 赴难
diren: 敌人
cengdie: 层叠
huze: 湖泽
erzhan: 二战
chule: 出了、除了
buxi: 补习、不息、不惜
huiju: 徽剧、汇聚
chadian: 茶点、查点
buzhou: 不周
hengliu: 横流
fengdian: 峰巅、疯癫
huakan: 画刊
daizhao: 呆着、带着
daolu: 道路
genzai: 跟在
hetang: 荷塘
gezi: 格子
gongsheng: 共生
hebao: 荷包
gongshang: 共商
chongkua: 冲垮
chuanshou: 船首
hubin: 湖滨
adi: 阿弟
dajin: 打紧、打进
beifeng: 北风
huolu: 活路
hanyi: 涵义、寒衣、寒意
bibang: 臂膀
heishui: 黑水
doule: 逗乐
douzhao: 兜着
haiku: 害苦
duokai: 躲开
annian: 按年、暗念
basai: 罢赛
jiayong: 家用
gongshi: 攻势、共识、共事
gouxiang: 构想
chaosu: 超速
banshu: 半数
feiming: 非命
guntang: 滚烫
baixue: 白雪
gaobai: 告白
bingzhong: 兵种、并重
huili: 回礼
jichuang: 机床
feixu: 废墟
chihong: 赤红
erzhui: 耳坠
caojie: 草芥
guiwai: 柜外
gangwu: 港务
huangluan: 荒乱
piyao: 辟谣
chutai: 出台
chuluo: 出落
genghuan: 更换
bizhi: 比值、笔直、笔致、币值、币制、壁纸
chuangba: 疮疤
gudian: 鼓点、古典
banben: 扳本、版本
eryi: 而已、二意
guadou: 挂斗
ciqu: 辞去、词曲
jixu: 积蓄、几许、记叙
zhaotian: 朝天
ganliang: 干粮
diaojia: 掉价、调价
ceyan: 测验
chuqiao: 出鞘
heding: 核定
daoda: 到达
huanju: 还具
hengdao: 横刀
chixia: 吃下
binhai: 滨海
bingxue: 冰雪
gunlai: 滚来
jifei: 基肥、积肥、既非
gunquan: 滚圈
heye: 荷叶
eji: 恶疾
bagong: 罢工
chaming: 查明
chuanxi: 喘息
buwu: 不无
jiwan: 几万
beiqi: 悲戚、悲凄、悲泣、北齐、背起、背弃、背鳍
gurou: 骨肉
buce: 不测
chapan: 茶盘
couqi: 凑齐
chongzu: 充足
chengjing: 乘警
cengji: 层级
guaming: 挂名
dichang: 抵偿
haocheng: 号称
hanchen: 寒碜
huisu: 回溯
gengsheng: 更生
ganlao: 干酪
huanwei: 环卫、还为、还未、换位
guaqi: 刮起
dizhuan: 地砖
benjin: 本金
chengpian: 成片
biming: 逼命、笔名、毙命
bianyan: 边沿
gouqu: 沟渠
fanghua: 访华
huangmo: 荒漠
changchuan: 长川
eshi: 恶事
jiceng: 基层、几曾
cizu: 词组
guke: 骨科
cila: 刺啦
jimai: 寄卖
chengxiong: 称雄、逞凶
huiwei: 回味
guina: 归纳
dianli: 典礼、电离、电力、店里
chazhang: 查帐
fangjiu: 访旧
gangtiao: 钢条
charan: 诧然
dubei: 都被
hangxiang: 航向
gudai: 古代
chaxiao: 插销
hunsi: 浑似
heixin: 黑心、黑信
caxi: 擦洗
henhao: 很好
dunang: 毒囊
guilong: 归拢
dongjiang: 冻僵
jimi: 机密
banqiu: 板球、半球
benjie: 本街、本届
fengzhi: 峰值
dudui: 都对
chenmi: 沉迷
baoan: 报案
huaya: 画押
fanmai: 贩卖
furao: 富饶
jiali: 家里
guguo: 古国、故国
cunduan: 寸断
biaojue: 表决
baohong: 暴洪
douzhi: 斗志、斗智
chisu: 吃素
buhuan: 不还
guachi: 挂齿
hangxiao: 航校
huagu: 花鼓
ciyang: 刺痒
banhen: 斑痕
changtan: 长谈、长叹、畅谈
guiti: 贵体
jiduan: 极端
canhai: 残骸、残害
jixie: 机械
chaixia: 拆下
ganniang: 干娘
donghuo: 动火
baozheng: 暴政
dingduo: 定夺
dache: 搭车
banjiu: 斑鸠、半旧
diuqi: 丢弃
gandao: 干道、赶到
canci: 残次
huitie: 回帖
dajuan: 答卷
changzhan: 场站
buceng: 不曾
gushou: 鼓手、固守
choukong: 抽空
bizui: 闭嘴
guaren: 寡人
bochang: 波长
huanqiu: 环球
banye: 半夜
helan: 荷兰
feifan: 非凡
chuifu: 吹拂
biexie: 瘪屑
jizhao: 吉兆
caiji: 采集
chaofeng: 嘲讽
bilu: 笔录、毕露、闭路、壁炉
jifen: 积分、积愤、激奋、激愤、几份、计分、记分
douzheng: 斗争
diyu: 抵御、地域、地狱
chuanjia: 船家
fanguo: 翻过
dujia: 度假
guijie: 归结
hena: 和那
dianchi: 滇池、电池
fanghong: 防洪
beiguang: 背光
disan: 第三
duhen: 都很
diaobi: 吊臂
huwei: 虎威、护卫、互为
cipan: 磁盘
celve: 策略
hualei: 花蕾
bingfeng: 冰峰
bangzi: 梆子、膀子
huizhuan: 回转
dusai: 堵塞
chaicheng: 拆成
chengfang: 城防、乘方
aizheng: 挨整、癌症
hengzhi: 横直
dunci: 遁词
feitu: 匪徒
eryan: 而言
caifeng: 裁缝、采风
heai: 和蔼
bingyin: 病因
chuantong: 串通
dundian: 蹲点
goumai: 购买
duantie: 锻铁
chuche: 出车
bingtuo: 冰坨
baozhang: 报章、报帐、暴涨
jidu: 基督、极度、几度、季度
antian: 安恬
huju: 沪剧
dijie: 地界
chuandai: 穿戴
ercong: 而从
haijun: 海军
geli: 割离、割礼、隔离
gaomi: 告密
huangcheng: 谎称
guanle: 关了
cunzhen: 村镇
houlu: 后路
heizi: 黑子
dongting: 动听
dupin: 毒品
erchui: 耳垂
cangying: 苍蝇
chukui: 初亏
banjia: 搬家、半价
jila: 棘剌
gongjun: 共军
erxin: 二心
gongxu: 共需
biedong: 别动
chuxing: 出行
cannian: 残年
hulu: 呼噜、葫芦、护路
gaoshi: 告示
duzhi: 毒汁
geri: 隔日
huanying: 还应
caizhai: 采摘
ersun: 儿孙
gangzou: 刚走
beihai: 北海、被害
bingqiu: 冰球
biegei: 别给
biaojie: 表姐
chenyi: 衬衣
banyue: 半月
diqi: 底气、第七
diaotou: 掉头、调头
geyin: 隔音
gangsi: 钢丝
chushuang: 除霜
beifei: 北非
henchang: 很长
dianliu: 电流
afei: 阿飞
baiyin: 白银
jihe: 几何
ganxian: 干线
chuiluo: 垂落
hede: 喝得
bizuo: 比作
huojiang: 获奖
baotong: 报童
bode: 剥得、博得
jigou: 机构
chuanwei: 船尾、串味
jiming: 寄名、记名
jiyou: 机油、极有、极右、既有
buke: 补课、不可、不克
duhua: 毒化
ganzhang: 干仗
huande: 还得
huajiang: 画匠
budeng: 不等
hanqing: 旱情、汗青
doushou: 兜售
huangpao: 黄袍、皇袍
heiguo: 黑锅
chigu: 耻骨、尺骨
fengqu: 风趣
bingwei: 病危、并未
gongying: 恭迎
jiya: 积压
chengfen: 成分、成份
choumou: 筹谋
changtong: 畅通
chaoliu: 潮流
ganlai: 赶来
caogao: 草稿
haijiang: 海疆
chuyao: 出窑
dinggao: 定稿
fabao: 法宝
guichang: 贵厂
gouzhen: 钩针
chixu: 持续
guotie: 锅贴
dianchuan: 点穿、电传
huacha: 花茶
guarang: 瓜瓤
chuangdan: 床单
guahao: 挂好、挂号
hefa: 核发
cizao: 辞藻、词藻
haifeng: 海风
dunju: 囤聚
huankuan: 还款
bengyou: 泵油
chanyi: 蝉衣
anruo: 暗弱
aodi: 奥迪
caiqi: 才气、财气、彩旗
chengqi: 称奇
choufeng: 抽风
chaoshou: 超收
changyuan: 长远
jiagong: 夹攻、加工
binpeng: 宾朋
jichang: 机场、机长
hudan: 虎胆
disi: 抵死、第四
houtai: 后台
zhaoshang: 朝上
biqiang: 鼻腔
fengyi: 风衣
guxun: 古训
chouxu: 愁绪
baozhi: 报纸
chaitai: 拆台
huangjia: 皇家
fengtan: 风瘫
guomin: 国民、过敏
chuanxing: 穿行
dianqing: 靛青
heian: 黑暗
dianman: 电鳗
benren: 本人、笨人
guafu: 寡妇
hushang: 湖上、沪上
guapi: 刮皮、瓜皮
dadian: 打点
huandang: 换档
haixian: 海鲜
caosheng: 草绳
jiapu: 家谱
chongchu: 冲出
huozhuo: 活捉
dieqi: 迭起
aiqi: 爱妻
baoku: 宝库、暴库
bingtang: 冰糖
jiacheng: 加成
dianxia: 殿下
dianlu: 电炉、电路
chuanglian: 窗帘
baifei: 白费
chusheng: 出声、出生
buyou: 不由
beisuan: 悲酸
ainv: 爱女
bubai: 不败
chatou: 插头
guokuai: 过快
dafu: 答复
fuzhe: 覆辙
chise: 赤色
cuowu: 错误
cechu: 测出
duzhuo: 赌桌
fuzhi: 福祉、副职
banlian: 板脸
guazhi: 挂职
danliang: 胆量
didang: 涤荡、抵挡
guanxin: 关心
bingdai: 冰袋
biaochi: 标尺、表尺
fushui: 赋税、腹水
dancan: 丹参
jiliao: 寂寥
bingshui: 冰水
huifan: 回返
bianpao: 鞭炮
bingqing: 病情、并请
doumiao: 痘苗
cuihui: 摧毁
jizan: 积攒
fanxiang: 凡响、反相、反响、反向
duiman: 堆满
bingdeng: 冰灯
haiba: 海拔
fengyu: 丰羽、丰裕、丰腴、风雨
diyun: 底蕴
huaran: 哗然
chahe: 查核
chuyue: 初月、出月
cangni: 藏匿
gonglao: 功劳
huirong: 毁容
ciqi: 磁漆、瓷器
bailei: 败类
huode: 活得、获得
anju: 安居
aomi: 奥秘
dujiu: 毒酒
diaosheng: 吊绳
chuiwen: 垂问
guangxi: 广西
guaidai: 拐带
gujin: 古今、股金
beibian: 北边
huabao: 花苞、画报
chuting: 出庭
dangdi: 荡涤
chunian: 初年
ganxi: 干洗、干系
baoma: 宝马
henruo: 很弱
guoqu: 过去
huangguan: 皇冠
fanshu: 番薯、凡属
buri: 不日
dungan: 顿感
heiyu: 黑鱼
baizhao: 摆着、败招
duyun: 赌运
huanghai: 黄海
caixie: 采写、采血、采撷
buguang: 不光
bingan: 病案、并按
fangjian: 房间
diaonong: 调弄
hailang: 海浪
chile: 吃了
fudiao: 浮雕、浮吊
baonue: 暴虐
defa: 得法
jishu: 基数、疾书、技术、记述、记数
hunzhan: 混战
douzi: 豆子、痘子
chaichuan: 拆穿
baicha: 白茶
fashu: 乏术、法术
chifa: 持法
canglong: 苍龙
hailun: 海轮
anpai: 安排、按排
bujin: 不仅、不进、不禁、不尽
chenzao: 趁早
dibao: 地堡
diaoling: 凋零、调令
guihun: 鬼魂、鬼混
banfei: 拌肥
chaoji: 超级
dulv: 镀铝
guoqing: 国情、国庆
hafo: 哈佛
chuimu: 垂暮
dipian: 底片
chidi: 池底
chishui: 池水
huijian: 回见
feibing: 肺病
gulou: 鼓楼
huoxian: 活现
canbu: 残部
guoyan: 国宴
gaojie: 告捷、告诫
hanzhan: 寒颤、寒战
fute: 福特
dazai: 搭载
jiamen: 家门
faqiu: 罚球
citan: 刺探
chengkuang: 成矿
bingtai: 病态
gengzheng: 更正
changmao: 长矛
baidai: 白带
chailing: 拆零
chuchang: 出场、出厂
chufa: 出发、除法
biankuang: 边框
buhan: 不含
dianfu: 颠覆
huntong: 混同
dixia: 底下、地下
cangcui: 苍翠
chuochuan: 戳穿
chuzai: 出在
daomai: 盗卖
jilun: 棘轮
gangguo: 刚果
huozhun: 获准
bude: 捕得、不得
gangqu: 刚去
huisheng: 回声、回升
hechang: 和畅
changpiao: 唱票
hebian: 河边
chendian: 沉淀、衬垫
bianzhi: 贬值
huanshang: 换上
huanjing: 环境
huoqu: 获取
aodao: 熬到
fating: 法庭
biede: 别的
exi: 恶习
doudie: 陡跌
fuhou: 附后
dengzhi: 等值
baibai: 白白、拜拜
daji: 打击
jixian: 基线、极限
caoxin: 操心
beihao: 悲号
duiji: 堆积
feiye: 肺叶、废液
baidu: 摆渡
jisui: 几岁
jigeng: 机耕
bofa: 播发、勃发
erceng: 二层
buzhen: 不振
bansi: 半死
anshi: 安适、按时、暗示、暗事、暗室
huanwen: 换文
buti: 不提
daqu: 打趣
chaoxiao: 嘲笑
jiaxin: 夹心、家信
heixian: 黑线
chengwen: 成文
fengshuang: 风霜
guotu: 国土
guilin: 桂林
chixiao: 耻笑
canku: 残酷
deyou: 得有
hanzhong: 汉中
anfa: 案发
zhaonan: 朝南
diaoer: 钓饵
benzhong: 本种、笨重
bobao: 播报
ganggan: 杠杆
huanqu: 还去、换取
hali: 蛤蜊
bushuang: 不爽
fangfeng: 防风
jigui: 极贵
ganggui: 钢轨
huoyang: 祸殃
guancai: 棺材
bianta: 鞭挞
fansu: 凡俗、反诉、返俗
henxiang: 很想
bachang: 靶场
chuizhao: 吹着
chongpo: 冲破
diaozhuo: 雕琢
bihua: 比划、笔画、笔划、壁画
dunzhao: 蹲着
diede: 跌得
doubing: 豆饼
hundun: 混沌
gugan: 骨干
erci: 二次
ganke: 干咳、干渴
daibing: 带兵、带病
baotiao: 暴跳
chuide: 吹得
bigong: 逼供、笔供
fanhua: 反华、反话
dula: 毒辣
chuanghuo: 闯祸
cankao: 参考
huifang: 回访、回放
fuyu: 抚育、赋予、富于、富余、富裕
zhaobai: 朝拜
chenzha: 沉渣
bagu: 八股
huya: 虎牙
huanyao: 还要
chaodeng: 超等
baishui: 白水
beican: 悲惨、钡餐
dingsheng: 鼎盛
beidong: 被动
beiju: 悲剧
baitang: 白糖、拜堂
dajia: 打假、打架
huimin: 回民、惠民
jileng: 极冷
jilou: 几楼
gongyong: 功用、共用
buxing: 不兴、不行、不幸
houtui: 后退
ganzhe: 甘蔗
beitao: 被套
ertong: 儿童
jiafa: 家法、加法
guoyao: 国药
ditai: 敌台
han*: 汉*
hanta: 喊他、喊她、旱獭
boli: 剥离、薄礼、薄利、玻璃
chuchu: 初出、出处
fengshou: 丰收
banma: 斑马
ganxiu: 甘休
guangdong: 广东
chongjun: 充军
gongchan: 共产
chongyong: 宠用
ergen: 耳根
huangpai: 黄牌
hexian: 河鲜
haozhao: 号召
baojun: 暴君
dingshang: 盯上、钉上
doudian: 逗点
houbei: 后备
fudi: 福地、府第、腹地
chuxie: 出血
gengshen: 更深
daohai: 蹈海
gengpa: 更怕
huizui: 回嘴
cansang: 蚕桑
chuangguan: 闯关
huaizhong: 坏种
dongshi: 董事
chuban: 初版、出版
fengbi: 封闭
chuancha: 穿插
aoguo: 熬过
huace: 画册
jixing: 基型、机型、畸形、吉星、极刑、即兴、即行、记性
anmian: 安眠
dazhuang: 打桩
biaoxing: 表形
chendiao: 沉掉
dingming: 定名
bengchu: 蹦出、迸出
fujian: 福建、附件
dianjiu: 碘酒
anbian: 岸边
huanqi: 唤起
diaodao: 吊到、调到
caifa: 采伐
duanchang: 段长
bingping: 冰瓶
huarun: 滑润
canzhan: 参展、参战
gean: 隔岸
changzhi: 厂址
aizou: 挨揍
gengjia: 更加
buba: 不把
balei: 芭蕾
duzai: 都在
houtou: 喉头、后头
fanyong: 翻涌
anan: 暗暗
guowai: 国外
dianbo: 颠簸、点播、点拨、电波
enshi: 恩师
daowei: 到位
huanduo: 还多
fujin: 附近
chushou: 出手、出售
guaimai: 拐卖
ciyan: 刺眼
banli: 搬离、办理
chuangong: 船工、串供
daizhuang: 带状
banshi: 板式、版式、半时、半世、办事
fuke: 副科
fanzao: 翻造
caoyu: 草鱼
duoshou: 舵手
huangwei: 皇位
huanpa: 还怕
huangye: 荒野
bugong: 不公
fengqin: 风琴
huanshan: 环山
biaomei: 表妹
fushou: 副手
ermu: 耳目
guangwei: 广为
caizheng: 财政
jiazhong: 家中
daicha: 待查
duanya: 锻压
buguo: 补过、不过
caguo: 擦过
dengni: 等你
guangmao: 广袤
changming: 昌明
daigong: 怠工
diaoru: 调入
jiafang: 家访
huanda: 还大
fufen: 福分
dingshen: 定神
duchuan: 渡船
jiaqing: 嘉庆
chashi: 茶室、查实
daochang: 到场、道长
chuqu: 出去、除去
dongnei: 洞内
chadui: 查对
daru: 打入
chitou: 吃透
butie: 补贴
jitiao: 几条
zhaohui: 朝晖
dixue: 地学
buduan: 不端、不断
chufan: 初犯
dongli: 动力
huizhou: 惠州
gonggu: 巩固
benxing: 本行、本性
binwei: 濒危
gongjian: 共建
dilai: 抵赖
fuli: 浮力、福利、富丽
duanzi: 段子
dingyi: 定义
huanguo: 换过
jikou: 籍口
bingti: 病体、并提
fangri: 访日
baiji: 白鸡、败绩
baba: 巴巴
gelou: 阁楼
benzi: 本子、本字
baonu: 暴怒
benbao: 本报
chuanbang: 川帮、船帮
fala: 法拉
baire: 白热
daopo: 道破
bankai: 搬开
haizang: 海葬
dingyin: 定音、订印
huatan: 花坛、画坛
fanlian: 翻脸
guicheng: 归程
houchen: 后尘
buying: 不应
dilei: 地雷
jigao: 极高
fengzheng: 风筝
huohuan: 祸患
fanmu: 反目
bingyao: 并要
futong: 浮筒、腹痛
fangun: 翻滚
darao: 打扰
bupiao: 补票
huanyuan: 还原、还愿
ezhan: 恶战
butai: 补胎、不太
daojie: 盗劫
cehua: 策划
gandang: 甘当
chuaice: 揣测
changzhao: 长着
deshi: 得失、得势、的士、的是
dongxiao: 洞箫
jiamu: 家母
jiaqin: 家禽
huoshui: 活水、祸水
anwei: 安危、安慰
duocang: 躲藏
jiqiu: 击球
ailian: 爱怜、爱恋
dianda: 电大
bazhan: 罢战
dadu: 打赌
biaozhun: 标准
dinggou: 订购
anshao: 暗哨
heihua: 黑话
cuozong: 错综
jicha: 稽查、极差
huaniao: 花鸟
daijun: 带菌
houchang: 后场
guanbu: 官步
gongcun: 共存
ali: 阿里
gujing: 鼓劲
bankuai: 板块
huapo: 滑坡、划破
chazhao: 查找、查照
bingchu: 并处
anxiao: 暗销
banzeng: 扳罾
duyou: 都由、都有
guohu: 过户
dire: 地热
baodao: 宝刀、宝岛、报到、报道
biankuan: 边款
didui: 敌对
hunao: 胡闹
chudao: 初到
chengjian: 城建、成见
caixue: 才学
biaoliang: 标量
ganglun: 钢轮
futie: 服贴
chujin: 出进
guanjiang: 灌浆
caliang: 擦亮
daizhi: 呆滞、带至
chushen: 初审、出身、出神
ceying: 策应
chonghui: 冲毁
guangdu: 广度
houjie: 喉结
baicai: 白菜
cangshen: 藏身
dakua: 打垮
anshe: 安设
caiquan: 财权
biting: 笔挺
biaoji: 标记、表记
baihua: 白花、白化、白话、白桦
beixian: 北线
chenxian: 沉陷
baiyu: 白鱼
beiku: 悲苦
bida: 笔答
binggen: 病根
huanzhai: 还债
chaoche: 超车
biaopai: 标牌
daitu: 歹徒
gengsai: 梗塞
fugui: 富贵
hanguang: 寒光
caiding: 裁定
fengying: 丰盈
bancuo: 板锉
gaoji: 告急
dengdai: 等待
guigeng: 贵庚
jiran: 既然
changhao: 长号
feique: 肥缺
chuanzhi: 船只
baili: 拜礼
chuidiao: 垂钓
dingfei: 鼎沸
bengkui: 崩溃
chizao: 迟早
diaoche: 吊车
aide: 爱得
jiduo: 基多、几多
buduo: 不多
diaoke: 雕刻
houguo: 后果
chaoran: 超然
hegu: 河谷
changyan: 肠炎
haibao: 海报、海豹
hanshan: 汗衫
diaoguo: 钓过
daozi: 刀子、稻子
huxue: 虎穴、互学
chouqu: 抽取、抽去
danshi: 胆识
caichou: 彩绸
gaoyue: 稿约
chuxia: 初夏
bianjie: 边界
houmen: 后门
baojin: 抱进
huanggou: 黄狗
huilv: 汇率
dunliang: 囤粮
dousou: 抖擞
caihuo: 采获
chihe: 吃喝
chuxi: 出息、出席、除夕
huanyou: 还有、患有
jiaceng: 夹层
chazu: 插足
dijian: 敌舰
gengzu: 梗阻
huile: 毁了
huaibei: 淮北
chengtuo: 秤砣
dangci: 档次
dingdan: 定单、订单
hengdang: 横档
anpan: 暗盘
gengying: 更应
guizhou: 贵州
guzhang: 鼓掌、故障
geqian: 搁浅
guren: 古人、故人
cangli: 藏历
danse: 淡色
daici: 带刺
dongqing: 动情
jiahuo: 家伙
guizui: 归罪
chaju: 茶具
gongzhong: 宫中
chuandui: 船队
anzhen: 安枕
caikuo: 彩扩
cileng: 刺棱
gonglv: 功率
erhou: 而后
diaoluo: 凋落
buhe: 不和、不合
hairen: 害人
heihuo: 黑货
faban: 法办
chuimie: 吹灭
bubian: 不便、不变
didai: 地带
haoma: 号码
baowu: 报务
dunqi: 钝器
daiyu: 带鱼、待遇
anxi: 安息、暗喜
bulai: 不赖
huishen: 回身
changqu: 厂区
chanlian: 蝉联
duda: 毒打
fouren: 否认
huatou: 花头、滑头、话头
guangbang: 广帮
changguan: 场馆、长官
fuyong: 服用、附庸
fanlong: 樊笼
chashang: 插上
hulan: 护栏
jiajin: 夹紧
jiqiao: 技巧
dashang: 搭上、打伤
guiju: 桂剧
hengyo: 哼唷
bianan: 边岸
fukan: 副刊
chengxian: 呈现
famen: 阀门、法门
bofu: 波幅
fangyu: 防御
heli: 贺礼
dandan: 淡淡
bingchuan: 冰川
huoji: 活计
bijin: 逼进、逼近
baiguo: 白果
erlao: 二老
danmai: 丹麦
jilei: 积累
changbu: 厂部
douou: 斗殴
buyan: 不严、不厌
anmo: 按摩
danyou: 担忧
gengbian: 更便
buna: 补纳
chengxin: 称心、诚心、诚信
bosa: 播撒
huapao: 花炮
guzhuang: 古装
buqing: 不清
doufa: 斗法
ganmang: 赶忙
bugu: 不顾
caishen: 财神
dianjie: 电解
benglie: 崩裂、迸裂
guji: 古迹、古籍
chashao: 查哨
binglie: 并列
basong: 巴松、罢讼
chizi: 吃子、池子、尺子、赤子、赤字、斥资
huatu: 画图
heiren: 黑人
andao: 暗道
duixing: 队形
henmei: 很美
guya: 古雅
jiguo: 记过
baisu: 败诉
choushen: 抽身
jiju: 机具、积聚、激剧、吉剧、极具、几句、寄居
banke: 班科
gele: 隔了
chuzi: 出资、出自
gengling: 更令
jifu: 基辅、肌肤、极富
huanxian: 环线、还嫌
doudu: 兜肚
huanyi: 还以、换衣
hechuan: 河川
chaoren: 超人
gaixing: 该行
dacha: 打岔
fanpu: 反扑
chushu: 出书、除数
bingxiang: 冰箱、并向
caodi: 草地
guozhi: 果汁
chashu: 茶树
chuixu: 吹嘘
biantao: 扁桃
biwo: 比我
guanggao: 广告
chongjin: 冲进
cuanwei: 篡位
fuguan: 副官
gengwu: 更无
guanguo: 关过
bianze: 贬责
chenghao: 称好、称号、乘号
houji: 后集、后记
congying: 聪颖
huanren: 换人
biaodi: 标底、表弟
echou: 恶臭
chongfu: 冲服
fanying: 帆影、反应、反映
anshen: 安身、安神
bingpai: 并排
bingtong: 病痛
gongji: 攻击、功绩、共计
chouyang: 抽样、臭氧
biaoceng: 表层
ewu: 讹误
guaiqiao: 乖巧
caizhi: 材质、才智
dujin: 镀金
genchu: 根除
hujiao: 呼叫、胡椒、胡搅
baoyu: 宝玉、暴雨
caochang: 操场、草场
diaoyang: 调养
chuzhong: 初中、初衷、出众
fengjing: 封镜、风景
huzeng: 互赠
ciping: 瓷瓶
diaoshang: 叼上、钓上
guibin: 贵宾
guoxi: 过细
fengmo: 风魔
huozui: 豁嘴
bingleng: 冰冷
huoli: 活力、获利
daotou: 刀头
chebing: 撤兵
chenji: 沉积、沉寂、趁机
chengxiao: 成效
fanmao: 翻毛
caodao: 操刀
chuangtou: 床头
bufei: 不菲
guanshu: 灌输
huangu: 环顾
guqin: 古琴
hanzai: 旱灾
chengzheng: 诚征
cansi: 蚕丝
buchuai: 不揣
huanxuan: 换选
chengdi: 呈递
bijiao: 比较
chishen: 赤身
fengru: 蜂乳
beida: 北大
deyi: 得宜、得以、得意、得益
danqing: 丹青
huichun: 回春
diaozai: 掉在
diaoxie: 凋谢、调谐
guigei: 归给
baijiu: 白酒
huisun: 毁损
cangnei: 舱内
ganhe: 干涸
baoqian: 抱歉
congtou: 葱头
baogao: 报告
cainong: 菜农
diushi: 丢失
anshang: 安上、暗伤、岸上
jitao: 几套
fuyuan: 幅员
chenbu: 衬布
bian: 彼岸
erqu: 而去
chuanghua: 窗花
haide: 害得
cuanquan: 篡权
canque: 残缺
bingyou: 并由、并有
baita: 白塔
baosong: 报送
biji: 比及、笔迹、笔记、避忌
gendiao: 根雕
chenshu: 陈述
bianchui: 边陲
bangbing: 棒冰
biwei: 逼为
guidan: 诡诞
huangliang: 荒凉、皇粮
gaochou: 稿酬
caigang: 才刚
dianche: 电车
aomo: 熬磨
fanjiao: 反角
duhui: 都会
gengyou: 更有
dukou: 渡口
changda: 长达、长大
hualuo: 滑落
biye: 毕业
zhaoxia: 朝霞、朝下
citiao: 词条
huangying: 黄莺
baihuai: 败坏
fanfan: 翻番
biaojia: 标价
dairu: 带入
biaoxiong: 表兄
baoquan: 抱拳
changgao: 长高
jijun: 季军
biance: 鞭策
baoxin: 报信
zhaozhong: 朝中
chongai: 宠爱
jiagan: 夹肝
gailv: 概率
chouku: 愁苦
guafen: 瓜分
hunchen: 昏沉
bangbu: 蚌埠
gongguan: 攻关、共管
huaban: 花瓣
guotai: 锅台
bingshuang: 冰霜
chongcha: 冲茶
ganji: 干急、赶集
jinian: 几年、记念
hugan: 互感
hunan: 湖南、昏暗
dutong: 镀铜
huxi: 呼吸、护膝
gumin: 股民
baoqi: 抱起
houhui: 后悔
heixiong: 黑熊
cunzhai: 村宅、村寨
fayu: 法语、法域
ganshou: 干瘦
datan: 打探
houshi: 后世、后事、后室
biaoqing: 表情
bire: 比热
baigong: 白宫
fenshao: 焚烧
bolan: 波兰、波澜、博览
jizai: 即在、记载
houhuan: 后患
diaogou: 吊钩、钓钩
chenmen: 沉闷
chazui: 插嘴
dizhai: 抵债
diceng: 底层
dianshang: 点上
benchang: 本厂
jili: 机理、激励、吉利、极力
bocui: 薄脆
jihui: 击毁、机会、几回、几会、寄回
gumo: 鼓膜
baoyi: 苞衣、胞衣、报以
caiyuan: 裁员、财源、菜园
bangzhen: 棒针
fanbo: 反驳
dujiang: 都江、都讲、渡江
heigui: 黑鬼
guer: 故而
benkan: 本刊
anqing: 安庆、案情
doudong: 抖动
dimian: 地面
guanya: 关押、管押
citou: 磁头
houzhui: 后缀
fankai: 翻开
dela: 得啦
changpian: 长篇、唱片
feifen: 非分
choupai: 抽牌
biaoyang: 表扬
geshe: 割舍
congcui: 葱翠
falv: 法律
caide: 采得
fengshang: 封赏、风尚
chanyan: 谗言
jiruo: 即若
caili: 财力
diaoliao: 调料
banji: 班机、班吉、班级、扳机、半级
haiwei: 海味
fangcao: 芳草
hewan: 喝完
bandian: 斑点、半点
choujiang: 抽奖
duxing: 都行、毒刑、毒性
baibing: 败兵
baota: 宝塔
jiaban: 夹板、加班
chufang: 出访
bingliang: 冰凉
canzhao: 参照
heiqiang: 黑枪
baoqu: 抱屈
aiting: 爱听
enhui: 恩惠
fanshai: 翻晒
changshi: 长逝、长势
guizi: 鬼子、柜子、贵子
cihai: 辞海
dafan: 打翻
bihe: 闭合
guashi: 瓜市、挂失
guodao: 国道、过道
bufen: 不分、不忿
dianlan: 靛蓝、电缆
chaorang: 吵嚷
guoduan: 果断
budie: 不迭
banche: 班车
bingcong: 并从
chuangtai: 窗台
beijiao: 背角
chuiniu: 吹牛
huisa: 挥洒
guofen: 过分
fangchan: 房产
ciju: 词句
canyue: 参阅、残月
bingfang: 病房
gulao: 古老
huamiao: 花苗
duiqi: 堆砌、队旗
dunzai: 蹲在
daqi: 搭起、打起、打气
hengdi: 横笛
chupin: 出品
jizhan: 激战
hewen: 喝问
hutong: 胡同、互通
bushi: 捕食、不失、不时、不识、不使、不是、不适
benfen: 本分
gaizhao: 该着
canren: 残忍
dizhao: 滴着
chenghong: 橙红
dianshi: 电视
fushe: 敷设、附设
caiguang: 采光
ditan: 敌探、地摊、地毯
hubu: 互补、互不
guishen: 鬼神
huoyue: 活跃
hequ: 核区
hengkua: 横跨
getian: 隔天
jizhu: 机主、寄主、记住
dilou: 底楼、地漏
daohuo: 到货
dianan: 点按
feiwu: 废物
baijin: 白金
huoxu: 或许
chanxia: 铲下
chidu: 尺度
guizha: 诡诈
guanqi: 关起、官气
gezhao: 隔着
dujian: 毒箭
dingwei: 定位
baoding: 抱定
diya: 抵押
huangbao: 谎报
huncai: 荤菜
chifan: 吃饭
fenshen: 焚身
guole: 国乐、过了
datou: 打头
guakong: 刮空、挂空
biequ: 别去
haiou: 海鸥
fenghan: 风寒
baikai: 摆开
bage: 八哥
haibin: 海滨
hangzang: 肮脏
baidao: 白道、拜倒
bingtui: 病退
heizhong: 黑种
houxin: 后心
dayin: 打印
huiyou: 回游
chiyao: 吃药
caiqie: 裁切
dongxing: 动刑
guanliao: 官僚
gongqiang: 宫墙
dijiao: 地窖
fouze: 否则
chugen: 除根
chaban: 查办
guoye: 过夜
bandeng: 板凳
gutou: 骨头
ditu: 地图
busuan: 不算
angang: 昂昂
guguai: 古怪
hangbiao: 航标
fuweng: 富翁
biguang: 避光
dongcha: 洞察
daojiao: 道教
gangshang: 港商
gongxin: 攻心
bingxu: 并需、并须
diaohua: 雕花、刁猾
beiyan: 悲咽、钡盐
exing: 恶性
guochi: 国耻
jikui: 击溃
diaozuan: 刁钻
henshou: 很瘦
cike: 刺客
fanzhan: 反战
fanzi: 贩子
changwei: 肠胃
bengru: 泵入
fengfan: 风帆、风范
fanyao: 反咬
hangxian: 航线
dexian: 得闲
chongdian: 充电
caidai: 彩带
houxu: 后续
hounian: 后年
aiqing: 爱情
dingbian: 定编
daoyuan: 道院
chuanti: 船体
fajin: 罚金
fanwei: 凡未、反胃、范围
hengchuan: 横穿
changchong: 长虫
liaowang: 瞭望
batai: 吧台、靶台
bianda: 鞭打
chechu: 撤出、撤除
biaoyan: 表演
gongfan: 共犯
guoqiao: 过桥
dongci: 动词
changkong: 长空
chengkuai: 称快、成块
gangping: 钢瓶
jiajiang: 嘉奖
edan: 鹅蛋
eyao: 扼要
dunpai: 盾牌
gengzhi: 耿直
fuqi: 服气、浮起、福气
gousi: 构思
dougong: 斗拱
gengqiang: 更强
chongqu: 冲去
faze: 法则
chaguo: 查过
changmian: 场面、长眠
genju: 根据
caozhi: 草纸
dafa: 打发、打法
bingli: 兵力、病理、病历、病例、并立
fangming: 芳名
hudie: 蝴蝶
huqin: 胡琴
ganglie: 刚烈
dajiao: 打搅
baochou: 报酬、报仇
buan: 不安、不谙
bachi: 把持
chuangjiang: 闯将
fouding: 否定
fawen: 法文
bichu: 逼出、笔触、壁橱
beibi: 卑鄙、被逼
hailiu: 海流
huangyou: 黄油、黄鼬、晃悠
bumang: 不忙
gaikuo: 概括
gengju: 更具
bengguan: 甭管
ganku: 干枯、干哭、甘苦
douwan: 逗玩
erzhe: 而这、二者
hengsheng: 哼声、横生
eshang: 额上
chuangban: 床板
chuanlian: 串连
bigeng: 笔耕
huichong: 蛔虫
biejia: 别家
dingyao: 叮咬、定要
chiqing: 吃请、痴情
daiban: 呆板、带班
cangjing: 苍劲
dixian: 底线
gedeng: 格登
dingyu: 定语
jiyue: 激越
hancheng: 汉城
ande: 安得
gange: 干戈
beiwei: 卑微、北纬、北魏
guwan: 古玩
bianqia: 边卡
chuangzhao: 床罩
daile: 带了
eryue: 二月
heyue: 和约、和悦
henman: 很慢
changqi: 长期、唱起
benbu: 本埠、本部
duicheng: 堆成
banqian: 搬迁
huangpo: 荒坡
henan: 河南
zhaoqi: 朝气
fangxiang: 芳香
fangzhen: 防震
duguo: 度过、渡过
jiafen: 加分
changjia: 厂家
benming: 本名
bibi: 比比
anjing: 安静
caoxie: 草鞋
buzai: 不再、不在
bandao: 搬到、扳道、半岛、半道
biaozhen: 表针
huala: 哗啦
chaixi: 拆洗
choucheng: 抽成
bimu: 闭幕
chizui: 吃罪
hebei: 河北
defang: 德方
bitong: 笔筒
changkuai: 畅快
beici: 卑辞
enai: 恩爱
eryu: 耳语
banmao: 斑蝥
daini: 带你
guitai: 鬼胎、柜台
jizeng: 激增
banzi: 班子、板子
congbao: 葱爆
chisheng: 吃剩
anbao: 暗堡
jiqing: 激情、吉庆、寄情
aiji: 埃及
bizhang: 蔽障、臂章
dianji: 点击、典籍、电击、电机、电极
baoxiong: 胞兄
chuzhang: 出帐
guangai: 灌溉
huimen: 回门
diangong: 电工
zhaodai: 朝代
enci: 恩赐
doufu: 豆腐
bangda: 棒打
caijun: 裁军
dazhen: 打针
chandao: 铲刀
conglv: 葱绿
chengpu: 诚朴
busheng: 不胜
antan: 暗探
chige: 吃个
bingfei: 并非
biaosao: 表嫂
buliao: 不料
chuanshao: 船艄
gushi: 股市、故世、故事
gengqu: 更趋
buxu: 不需、不许、不恤
huoluan: 惑乱、祸乱
gendi: 根底
fuze: 附则
daota: 到他、到她
guge: 骨骼
buyuan: 不远、不愿
fanbang: 番邦、反绑
duci: 毒刺
dili: 地理、地力
gangcai: 刚才、钢材
changnian: 长年
hehu: 呵护
dejiang: 得奖
guaiguai: 乖乖
chuanguo: 穿过
diaoju: 钓具
guajian: 挂件
guofu: 国父、果脯
gunong: 咕哝、雇农
famei: 罚没
chuangyan: 窗沿
buxiang: 不相、不详、不想、不像
chiku: 吃苦
fanchu: 反刍
chashou: 插手、查收
haixing: 海星
didao: 地道
jige: 及格、几个
chizhun: 吃准
dingxia: 订下
erke: 儿科
hongchuan: 哄传
beiru: 被褥
bucong: 不从
caichan: 财产
daoni: 到你
daidui: 带队
huahui: 花卉、花会
chaihui: 拆毁
changdao: 肠道
dazhong: 打中
chongqing: 虫情
erxi: 儿媳、儿戏
baojian: 宝剑
baobei: 宝贝
baiwan: 白玩
fuxian: 浮现
fandang: 反党
houhua: 后话
bengtiao: 蹦跳
huange: 换个
duocheng: 剁成
beikong: 被控
cangsang: 沧桑
gonghou: 恭候
hulin: 护林
deque: 的确
gengnan: 更难
erxing: 而行
huawen: 花纹
bixian: 避嫌
chuiai: 垂爱
bishou: 笔受
fuwu: 服务
cishi: 磁石
boshu: 波束、帛书
jiasuo: 枷锁
diaowei: 调味
jiachang: 家常、家长、加长
huankou: 还口
dacuo: 答错
baimian: 白面
gangling: 杠铃
jixi: 即席
daiguo: 带过
guanmu: 棺木、灌木
chuizai: 吹在
bisheng: 毕生
changle: 长了
bianjing: 边境
chenjing: 沉井
biaobang: 标榜
huiyin: 回音
bufan: 不凡、不犯
aimu: 爱慕
guanqia: 关卡
jiazhai: 家宅
baixu: 败絮
guozang: 国葬
ganqu: 干渠、赶去
boban: 薄板
deyang: 德阳
gehe: 隔阂
hengchi: 哼哧
caodui: 草堆
chewu: 彻悟
guzhu: 雇主
dizui: 抵罪
dahua: 搭话、答话、打滑
bainen: 白嫩
chanhe: 搀和
jiamian: 嘉勉
dingneng: 定能
hundan: 浑蛋、混蛋
chase: 茶色
huihuai: 毁坏
chidian: 吃点
anquan: 安全
houliang: 后梁
dailai: 带来
dubao: 读报
gangqin: 钢琴
caiyun: 财运、彩云
fangqu: 防区
guanshe: 关涉
baoxing: 暴行
jizhai: 极窄
huangti: 黄体
fubu: 腹部
buai: 不爱
bangchui: 棒槌
chaifen: 拆分
bandiao: 搬掉
fenghua: 丰华、风化、疯话
fuzhou: 福州、抚州
huanyang: 豢养
aige: 挨个
chuangxiao: 窗销
dadong: 打动
fengwo: 蜂窝
biaoding: 标定
duchu: 读出
huihan: 回函
daqiang: 搭腔
bielun: 别论
fengbei: 丰碑
guochou: 国仇
duzhen: 毒针
daiyou: 带有
fuzui: 服罪
fengchan: 丰产
hongqiang: 哄抢
fanbei: 反被
chiping: 持平
fengqi: 蜂起、风气
beizha: 被炸
fuzi: 浮子
feipin: 废品
gongqu: 攻取
chili: 吃力、斥力
bannong: 搬弄
beizhou: 北周
guiyu: 归于、鬼蜮
benke: 本科
chushi: 初时、初始、初试、出使、出示、出世、出事
chafang: 查访、察访
houdun: 后盾
ganxin: 甘心
bita: 逼他、逼她、比他、比她
fakuan: 罚款
baowan: 宝玩
huying: 呼应
bingcan: 病残
bendui: 本队
huangdao: 荒岛、黄道
chuanzha: 船闸
cuochu: 错处
fubiao: 浮标、附表
gunbang: 棍棒
guanxia: 管辖
zhaoxian: 朝鲜
aman: 阿曼
baifa: 白发
heqia: 和洽、贺卡
cixiang: 慈祥
gongguo: 功过
douhua: 豆花
bugai: 不该
changcheng: 长城、长成
binke: 宾客
hangai: 涵盖
bangong: 办公
changdui: 长队
guixia: 跪下
ganzang: 肝脏
baoen: 报恩
chuming: 出名、除名
bisu: 鄙俗
douchuang: 痘疮
chushan: 出山
jishao: 极少
caozuo: 操作
jisu: 激素、寄宿
dengxiao: 等效
gongmo: 巩膜
guanchuang: 关窗
anfang: 安放、暗房
dushou: 毒手
banlan: 斑斓
chenggou: 秤钩
biyun: 避孕
hongnao: 哄闹
ceju: 测距
huasheng: 花生
douqiao: 陡峭
fanjian: 翻建、反间
dianti: 电梯
diansheng: 电声
fengtiao: 封条
hezi: 核资、核子、赫兹
choumei: 愁眉、臭美
dugun: 赌棍
huixie: 挥写
beichu: 辈出
canban: 参半
jizhong: 击中、机种、几种
bajiu: 把酒
huaisi: 坏死
baima: 白马
canyu: 参与、参预、残余
haoda: 浩大
changzi: 场子、长子、肠子、厂子
baida: 白搭
chenxi: 晨曦
haigang: 海港
daoqiang: 刀枪
hengpi: 横批
guihuo: 鬼火
changsheng: 昌盛、长绳、唱声
duopan: 舵盘
baodie: 暴跌
bentu: 本土
bini: 比拟、比你
feibo: 菲薄
guoyi: 国医
chengli: 城里、成立
aomen: 澳门
benguan: 本官
bairi: 白日
aoxin: 熬心
guxian: 股癣
cuiniao: 翠鸟
diaoyun: 调匀、调运
huilai: 回来
jilv: 几缕
chaobo: 超薄
beining: 贝宁
bali: 巴黎
ganlu: 甘露、赶路
guoba: 锅巴、过把
hengliang: 横梁、衡量
guigen: 归根
buyang: 哺养、补养、不扬
daipi: 待批
hunran: 浑然
baituo: 白脱、摆脱、拜托
gechu: 割除、革出、革除
erwei: 而为
hengshi: 横尸
bochan: 薄产
dupi: 肚皮
erjin: 而今
cailiao: 材料
huangzhao: 皇朝
hangsu: 航速
ershi: 而是、儿时、二是
chizhong: 持重、池中
haishui: 海水
haishang: 海上
fangbing: 防病
danjia: 担架
dianxun: 电讯
guosang: 国丧
huobian: 豁边
chuichu: 吹出
cuoshang: 磋商
huzou: 胡诌
huansuan: 还算、换算
chonggong: 充公
dixi: 底细
changjiang: 长江
goutong: 沟通、苟同
hejiu: 喝酒
guanchang: 灌肠
huangdou: 黄豆
fajing: 法警
gongrang: 拱让
feichu: 废除、废黜
chutan: 出摊
bawu: 巴乌
guashuai: 挂帅
chayi: 诧异
chongzou: 冲走
huazuo: 画作
gaiyao: 概要
dalao: 打捞
fengshi: 风湿、风蚀、风势
ganle: 干了
baoxi: 报喜
ganghao: 刚好
jiajian: 加减
huacheng: 画成
bingmao: 并茂
guoyuan: 果园
chenggan: 秤杆
huinuan: 回暖
chuhun: 初婚
caoyuan: 草原
chengneng: 逞能
huzhou: 湖州
ganjiang: 干将
aomao: 澳毛
beisha: 被杀
bohei: 波黑
cipin: 疵品、次品
fanche: 翻车
haiguan: 海关
beizi: 杯子、被子
bimen: 闭门
buzheng: 补正、不正
jicun: 积存、寄存
chuanhong: 川红
gainai: 钙奶
daoqian: 道歉
anxia: 按下、暗匣、暗下
celiang: 测量
huji: 户籍
fanchou: 范畴
changjie: 长街
chudai: 楚代
bosong: 播送
dengji: 等级
doulan: 兜揽
jizhua: 棘爪
anfan: 案犯
hunyao: 混淆
gaoci: 告辞
chaonao: 吵闹
dayi: 答疑
bushou: 不受
danbo: 淡薄
haojie: 浩劫
jigai: 技改
canghai: 沧海
deji: 得计
ciyi: 词义
heitu: 黑土
benlai: 本来
fuci: 副词
bishi: 逼视、比试、鄙视、笔势、笔试
chengkong: 程控
bushu: 不熟
daoli: 道理
fuxu: 抚恤
caixiang: 才向
fafang: 法方
chenglou: 城楼
chidai: 痴呆
dingzhi: 定址、定制
chengbao: 城堡、呈报
bingbao: 冰雹、并报
buping: 不平
baitian: 白天
buneng: 不能
guike: 贵客
caoben: 草本
honggou: 鸿沟
bipei: 比配
danfang: 丹方
fucong: 服从
aiguo: 挨过、爱国
dibiao: 地表
ganguo: 干果、干过
chengzhong: 城中
dianhui: 电汇
bianmao: 鞭毛、边贸
biyu: 比喻、碧玉、避雨
chentong: 沉痛
diduan: 地段
chouji: 筹集
hangkong: 航空
guanyong: 管用
canyang: 残阳
danya: 淡雅
guiyuan: 桂圆、贵院
daofei: 盗匪
erpan: 耳畔
huiyue: 毁约
guichu: 归除
gaozhi: 稿纸、告知
fuhe: 符合、附和
huikuan: 汇款
huai: 互爱
huanben: 还本
guashang: 挂上
chennian: 陈年
bingfa: 兵法、并发
chulong: 出笼
daoluan: 捣乱
bixia: 笔下、陛下
gainian: 概念
hanqi: 寒气
henwan: 很晚
henlei: 很累
chuijin: 吹进
bidiao: 笔调
gaotui: 告退
dayan: 打眼
chengming: 成名
cuanchu: 蹿出
fudu: 幅度、服毒
chengsong: 称颂
biantie: 扁铁
bingkong: 冰孔
charu: 插入
fuer: 附耳
cuoguai: 错怪
dongqi: 动气
debian: 得便
hujiang: 虎将
guoben: 国本
duoru: 堕入
fuxiu: 腐朽
gangqiao: 刚巧
duishang: 队上
dunji: 囤积、遁迹
dagong: 打工
daci: 答辞、答词
guobiao: 国标
fangdong: 房东、防冻
fajun: 法军
chongzi: 虫子
cuxin: 簇新
daxie: 答谢
jiyi: 机翼、极易、极意、几亿、技艺、计议、记忆、既已
cuyong: 簇拥
chuanyuan: 船员
huihuo: 挥霍、回火
dansheng: 诞生
fenggang: 封港
gezai: 搁在
guofang: 国防、过房
chuantai: 船台
dianxian: 电线
houzuo: 后座
chifeng: 赤峰
dinglun: 定论
diaosuo: 吊索、调唆
ganbu: 干布、干部
guaipian: 拐骗
bianmin: 边民
ganzi: 甘孜、杆子、竿子、秆子
chujia: 出家
fuhua: 孵化、腐化
beimian: 北面、背面、被面
huijia: 回家、汇价
baizu: 白族
jici: 几次
beiguo: 北国、背过
bajie: 巴结
anpou: 安瓿
guzheng: 古筝
baijia: 败家
diaogao: 调高
huoxin: 祸心
aotuo: 奥拓
damo: 打磨
fandi: 翻地
haiyu: 海域
duxin: 镀锌
bieming: 别名
buming: 不明
dizhen: 地震
gengbei: 更被
jiaju: 夹具、家居、家具
dengle: 瞪了
ganzuo: 甘作
douzui: 斗嘴
eryao: 而要
fenglang: 风浪
chukai: 除开
anle: 安乐、按了
desheng: 得胜
guoji: 国籍、国际、过激、过急
chachao: 查抄
bujia: 补假、不佳、不假
dongcheng: 冻成
eming: 恶名
haichong: 害虫
huandeng: 还等
dumo: 镀膜
gutai: 固态
chaoshui: 潮水
hunjun: 昏君
genzhi: 根治
guanjiao: 管教
fushu: 服输、附属
diaoji: 调集、调剂
bahen: 疤痕
fuxia: 服下
fanzheng: 反正、反证
huangtu: 黄土
coulong: 凑拢
huokou: 豁口、活口、活扣
heike: 黑客
dianya: 典雅、电压
huashao: 花哨
dingjia: 定价
gufen: 骨粉、股份
gangding: 钢钉、钢锭
baitui: 败退
dizi: 笛子、底子
fanba: 反把
fulan: 腐烂
bufang: 不妨
biezhen: 别针
jishou: 棘手
dandu: 丹毒
biaolian: 表链
chuanju: 川剧
gongtong: 共同
cede: 测得
bizhao: 比照、比着
guidui: 归队
guanru: 灌入
hubo: 湖泊
cancun: 残存
changpan: 唱盘
dianzi: 点子、电子
erna: 而那
gudong: 咕咚、鼓动、古董、股东
dairen: 歹人、带人
jitai: 几台
cuohui: 错会
chongci: 冲刺
chiqu: 吃去
beiji: 碑记、北极、背脊
huobao: 活宝
jihu: 几乎
boji: 波及、搏击
jizou: 疾走
heidian: 黑店
dengzhao: 等着、瞪着
zhaoqian: 朝前
huangchong: 蝗虫
bomian: 薄面
feiliao: 肥料、废料
huaishui: 坏水
bipo: 逼迫
chayan: 查验、察验
caonei: 槽内
gupu: 古朴
hulai: 胡来
huifu: 回复
bodiao: 剥掉
congyou: 葱油
cedao: 测到
huanong: 花农
fazi: 筏子、法子
chengche: 乘车
caituan: 财团
ada: 阿大
chuanru: 穿入
jisheng: 几声、寄生
biaopi: 表皮
gongcong: 共从
guohe: 过河
genzong: 跟踪
chapu: 查铺
huanggua: 黄瓜
conglong: 葱茏
gengyi: 更衣、更易
jidong: 机动、激动
guisu: 归宿
changting: 长亭
huixing: 秽行
guojiao: 国脚
diaochuang: 吊床
anyue: 按月
cezi: 册子
guohuo: 国货、过火
huyu: 呼吁
dinglv: 定律
digao: 底稿
feiai: 肺癌
buxuan: 补选
baishe: 摆设
huanhao: 还好、换好
diule: 丢了
canxue: 残雪
houqin: 后勤
chuli: 出力、矗立
heise: 黑色
chidun: 迟钝
candu: 残毒
haian: 海岸
baotu: 暴突、暴徒
chongmo: 冲模
diuque: 丢却
anxiang: 安祥、安详、暗箱
chu*: 锄*
beiliang: 悲凉
achang: 阿昌
dingjin: 定金
gujiao: 骨胶
biaoxian: 表现
balin: 巴林
fengya: 风雅
bieguo: 别国
duyao: 都要、毒药
dian: 堤岸
chengshi: 城市、乘势、程式、诚实
fanzhou: 泛舟
huanyu: 环宇、还与
caise: 彩色
bobo: 勃勃
dexing: 德行、德性
duwu: 毒雾、毒物、读物
hanxin: 寒心
biansun: 贬损
chenguang: 晨光
chongya: 冲压
guaiwan: 拐弯
daibu: 逮捕
feitie: 废铁
daochu: 到处、道出
haixiao: 海啸
cunmin: 村民
beixin: 悲辛、背心
baizhi: 白纸、白质、白芷
baoshang: 报上
henpang: 很胖
daoxie: 道谢
anban: 案板
bawan: 八万、把玩
diming: 抵命、地名
bingba: 并把
buken: 不肯
hetun: 河豚
jibi: 击毙
danzi: 担子、胆子
choubei: 筹备
bodou: 搏斗
caomao: 草帽
fudai: 附带
anggui: 昂贵
bugan: 不干、不甘、不敢
feizao: 肥皂
bacheng: 八成
guacai: 挂彩
houpai: 后排
gangyin: 钢印
ganhan: 干旱
guonan: 国难
gongtu: 共图
ebian: 恶变
chicheng: 赤诚
choujie: 筹借
caibing: 裁并
guigan: 贵干
cuican: 摧残
anmen: 暗门
chonggao: 崇高
huirao: 回绕
duye: 毒叶、毒液
huamian: 画面
bailian: 白蔹
binchu: 摈除
huanjiang: 还将
caishou: 采收
hanyuan: 韩元
baifang: 白方、摆放、拜访
banbao: 板报、办报
gongheng: 共亨
chongfen: 充分
buyun: 不允
chizhi: 迟滞
changdu: 长度
chizu: 赤足
gongde: 功德
chumai: 出卖
boen: 波恩
jiagao: 加高
huanlai: 换来
guanfu: 官服
ganggang: 刚刚、杠杠
heidao: 黑道
fengyuan: 风源
chongyang: 崇仰
gengdie: 更迭
changjing: 场景
banzhi: 办置
huifa: 挥发
huqu: 湖区
huajia: 花甲、花架、画夹、画家、画架
fangchen: 防尘
chengjiao: 城郊、成交
dizhang: 抵帐
jihao: 极好、几号、记号
ganzou: 赶走
heizao: 黑枣
daoguo: 到过
genxu: 根须
dushi: 都是、都市
dianmen: 电门、店门
chajiu: 查究
bingzhi: 秉直、病枝
diaoshan: 吊扇
hongmo: 虹膜、洪魔
gandiao: 干掉
huanxie: 换血
fengluan: 峰峦
anhan: 暗含
fengcai: 风采
diaohuan: 掉换、吊环、调换
anxian: 安闲、暗线
guifang: 闺房
beizuo: 碑座
bengxiang: 甭想
chae: 诧愕
huoqi: 活期
canbao: 残暴
chenshui: 沉睡
bufa: 补发、不乏、不法
geceng: 隔层
hundao: 昏倒
fengding: 封顶、峰顶
gongda: 攻打
dijun: 敌军
guiqi: 归期
cuoluan: 错乱
changlao: 长老
chenxing: 晨星
jiaxiang: 家乡
hanyao: 寒窑
jinuo: 基诺
dongbi: 动笔
fanyaofanyong: 凡要凡庸
jilie: 激烈
bawo: 把我、把握
ciku: 词库
bianye: 遍野
chubing: 出兵
diping: 地坪
fumei: 赴美、覆没
feizha: 废渣
deli: 得利、得力
banv: 吧女
changbie: 长别
huyang: 护养
chaye: 插页、茶叶、查夜
geshi: 格式、隔世
jiyin: 基因、汲引
bimei: 比美
cuiruo: 脆弱
gensui: 跟随
funong: 富农
chouyou: 臭鼬
huopo: 活泼
huilu: 回炉、回路、贿赂
cangzai: 藏在
chongbai: 崇拜
feipao: 肺泡
fengguan: 凤冠
geqi: 割漆
bifeng: 笔锋、避风
chouban: 筹办
bingqi: 兵器、冰期
cidai: 磁带
daofeng: 刀锋
dule: 读了
coujin: 凑近
huanya: 换牙
eyi: 恶意、遏抑
chudeng: 初等
guolu: 锅炉、过路
guoshang: 过上
huidiao: 毁掉
fangshu: 防暑
bingkuang: 病况
chaigou: 豺狗
dianle: 点了
binglian: 并联
diaoshe: 调慑
daoyong: 盗用
bumiao: 不妙
hedi: 河堤、河底
hedian: 喝点、核电、贺电
bairun: 白润
diuqu: 丢去
chuchen: 除尘
bayi: 八一
dianpo: 点破
bicheng: 鄙称
bujue: 不觉、不绝
huangtan: 荒滩
gaofu: 告负
guding: 固定
caoti: 草体
bisi: 鼻饲
heimu: 黑幕
gongzhen: 共振
huazai: 花在
bingyi: 兵役、并已、并以
guoqian: 过谦
dianqi: 电器、电气
fanglao: 防老、防涝
beiping: 北平
dongji: 动机
dandai: 担待
banyuan: 半圆
fangdu: 防毒
chakan: 查勘、查看、察看
banfa: 办法
chongtu: 冲突
gantian: 甘甜
jiqiang: 机枪、极强
fanben: 翻本
guanbi: 关闭
chongcheng: 冲程
daiqiang: 带枪
canjian: 参见
baihui: 白灰、拜会
dagun: 打滚
badou: 巴豆
huanzhang: 还帐
gaiyuan: 该院
jiqian: 积欠、几千
bairen: 白人、白刃、拜认
dade: 打的
caopi: 草皮
caifang: 采访
dujuan: 杜鹃
banshua: 板刷
jiqie: 激切
cangshan: 苍山
dongyi: 动议
fengge: 风格
hansuan: 寒酸
citi: 磁体
baochang: 报偿
aixi: 爱惜
guoran: 果然
fengjian: 封建
daoyi: 道义
huangyan: 晃眼、谎言
eryong: 二用
chaoe: 超额
gedou: 格斗
buchong: 补充
anran: 安然
huasuan: 划算
dengyu: 等于
anci: 按此
chongchi: 充斥
budang: 不当
babi: 罢笔
baiyou: 白鼬、柏油
dushe: 毒蛇
huizong: 汇总
fenxiang: 焚香
fankang: 反抗
aishuo: 爱说
genta: 跟他、跟她
degai: 得该
fanji: 反击
huida: 回答
jizhi: 机制、机智、极致、及至、几只
douqi: 斗气
fentou: 坟头
andan: 暗淡
fuai: 抚爱
caishang: 踩上
fenshan: 坟山
huli: 护理、互利
fayi: 法医
baijing: 白净
baocheng: 报呈
binggui: 冰柜
fankui: 反馈
bange: 半个
fengnian: 峰年
fangshui: 防水
chaoyue: 超越
chengban: 惩办
duceng: 镀层
danqi: 担起、氮气
airen: 爱人
diaozou: 调走
guzhi: 骨殖、骨质、故知、固执
chongji: 充饥、冲击、冲积、冲剂
erqie: 而且
fudong: 浮动
chaizi: 拆字
guafeng: 刮风
chuiguo: 吹过
dizhou: 地轴
diaolan: 吊篮、吊兰
caigeng: 菜梗
dashou: 搭手、搭售、打手
chuyuan: 出院
banan: 办案
guochan: 国产
fengman: 丰满
gangzai: 刚在
banzai: 半载
chuixia: 锤下、垂下
houguan: 喉管
hechi: 呵斥、河池
chuci: 初次
chayang: 插秧
feitian: 肥田
haoqi: 浩气
chongxie: 充血
ehua: 恶化
baiyao: 白药
guangsha: 广厦
danzhi: 胆汁
chuaidu: 揣度
huafei: 花费
congming: 聪明
bingwang: 并网
ditie: 地铁
chehui: 撤回
chengchong: 成虫
biaoqiang: 标枪
jichou: 计酬、记仇
ajie: 阿姐
guitu: 归途
buqiu: 不求
gansu: 甘肃
huoze: 或则
hanxuan: 寒喧
goujin: 购进
gaobie: 告别
baoshai: 暴晒
benlei: 本垒
huhao: 呼号
bushui: 补税
changtou: 场头
changge: 唱歌
geming: 革命
diechu: 迭出
gongmen: 宫门、拱门
huanbao: 环保、环抱
caishi: 才识、才使、才是、财势、菜市
huzi: 胡子、虎仔
hongliang: 洪量、洪亮、宏亮
hailuo: 海螺
chanhai: 谗害
jifa: 击发、激发、技法
hangchuan: 航船
dunshi: 顿时、遁世
baomin: 暴民
dingge: 定格
cangmang: 苍茫、苍莽
benzhi: 本职、本质
jiazhao: 夹着
furen: 赴任
hangzhan: 航展
dianyuan: 电源、店员
hanjian: 罕见
guojia: 国家
guyong: 雇佣、雇用
baipiao: 白票
chuizou: 吹奏
houche: 后撤
ehuang: 鹅黄
beishang: 悲伤、北上、背上
huanrao: 环绕
guban: 古板
bishang: 闭上、壁上、臂上
baige: 白鸽
ancang: 暗舱、暗藏
gangmen: 肛门
guntong: 滚筒
fengdeng: 丰登
gengduan: 更短
binglun: 冰轮、丙纶
dishang: 地上
huozhi: 获知
hama: 蛤蟆、哈蟆
fushun: 抚顺
caocao: 草草
hengfu: 横幅
erong: 鹅绒
guoyin: 过瘾
genban: 跟班
huishi: 挥师、回师、回事
haixia: 海峡
huabi: 画笔
huajing: 滑精、画境
jiye: 基业
difang: 堤防、敌方、地方
jisuan: 计算
haqi: 哈气
guidao: 跪倒
gailve: 概略
hengguan: 横贯
ainan: 碍难
baicheng: 白城
bingbu: 并不
guonian: 过年
guopin: 果品
daogao: 祷告
fengliu: 风流
cunzhong: 村中
zhaozheng: 朝政
cichang: 磁场
elang: 恶浪
duozai: 躲在
banchuang: 板床
chaonong: 嘲弄
gaole: 告了
guixing: 贵姓
huaquan: 花圈
caijin: 菜金
butan: 不谈
ajiao: 阿胶
bujiao: 补交
jichen: 击沉
chengqu: 城区
gaopo: 告破
bingzhu: 柄竹、病猪
bingcheng: 秉承、并称
gelv: 革履、格律
dezhu: 得主
baoshan: 宝山
beijie: 碑碣、被劫
chaogao: 超高
jimin: 机敏
cangwen: 藏文
anxin: 安心
huangyu: 黄鱼、谎语
aizi: 爱子
cuizhu: 翠竹
dadui: 答对
fenlan: 芬兰
houren: 后人、后任
chenchuan: 沉船
geye: 隔夜
bianbu: 遍布
chengshu: 成熟、乘数
beigao: 被告
feipang: 肥胖
guxiang: 故乡
huicheng: 回程、汇成
baobing: 抱病、暴病
benshi: 本事、本是、本市
chuilai: 吹来
cailve: 才略
fengcun: 封存
daolai: 到来
fazhi: 法制、法治
duzhu: 堵住、赌注
chongliang: 冲凉
hanliu: 寒流
jiqu: 汲取、寄去、记取
guran: 固然
dadang: 搭档
daoban: 盗版
binzhu: 宾主
gangtao: 钢套
fangte: 防特
boyuan: 波源
gongdeng: 宫灯
hengyue: 横越
chahuo: 查获
heihu: 黑户
coushu: 凑数
gengzhong: 更重
hengjia: 横加
anding: 安定
fuxiao: 附小
chulai: 出来
bochu: 播出
baogu: 苞谷
huaihai: 淮海
dujie: 堵截
gexing: 隔行
chourong: 愁容
guanbing: 官兵
fuhao: 符号、富豪
aishi: 碍事
changdi: 场地、长堤、长笛
duile: 堆了
heishou: 黑手
guishu: 归属
hunfang: 混纺
guanzai: 关在
gengxiang: 更想
guoshen: 过甚
diwo: 敌我
changjiu: 长久
jiasi: 家私
hengxian: 横线
chaikai: 拆开
huilin: 毁林
baoting: 报亭
dianwai: 殿外
erwu: 耳呜
dingqi: 定期
bitan: 笔谈
changchu: 长出、长处、唱出
huangnian: 荒年
dianci: 电磁
gongting: 宫廷
enren: 恩人
hanku: 寒苦
bufu: 不符、不服、不复
aobao: 敖包
hulv: 湖绿
guiyang: 贵阳
gutu: 故土
jiazei: 家贼
genben: 根本
gekai: 割开、隔开
danfei: 氮肥
diaoxiao: 吊销、吊孝、调笑
jifang: 机房、寄放
huibing: 回禀
bani: 把你
ganliu: 干流
dubo: 赌博
henhuai: 很坏
gangguan: 钢管
bodong: 波动、搏动
huajuan: 花卷、画卷
fanchuan: 帆船、翻船、反串
diaozi: 调资、调子
biaogu: 表姑
gaidao: 该到
cuokai: 错开
guqi: 鼓起、鼓气、骨气
cishan: 慈善
chuwai: 出外、除外
fuguo: 服过、富国
fadu: 法度
bilan: 碧蓝
benli: 本利
biaoce: 表册
jimu: 积木、吉姆、极目
jikao: 稽考
dinghun: 订婚
dunsheng: 顿生
fangxun: 防汛
huidie: 回跌
bibo: 鄙薄、碧波
caqu: 擦去
baohen: 抱恨
chongshu: 充数
huanhuo: 换货
hengyi: 横溢
chagang: 查岗
banshui: 拌水
ganshe: 干涉
gongshou: 攻守、拱手
canzan: 参赞
diedang: 跌荡
huomian: 豁免
diaobao: 碉堡、调包
bailu: 白露、白鹭、败露
bopu: 波谱
deti: 得体
hengxia: 横下
gongnv: 宫女
guanji: 关机
buqi: 补气、不齐
fawang: 法网
dunhao: 顿号
huangpian: 谎骗
buchu: 不出
huanzhe: 患者
dimo: 笛膜、地膜
cale: 擦了
ganzai: 赶在
bulun: 不论
banfang: 班房
caiyou: 才有、采油、菜油
jiwei: 机尾、积为、极为、即位、几位、记为
chensi: 沉思
henei: 河内
chakao: 查考
feichang: 非常
chengzhao: 乘着、诚招
houfu: 后福
cuoshi: 措施、错事
butu: 不图
bucha: 不差
debing: 得病
haima: 海马
budao: 不到
chousi: 抽丝、愁思
diaoren: 调任
cuolou: 错漏
genshi: 根式
angran: 昂然、盎然
anzhong: 暗中
canzhuo: 餐桌
bulin: 不吝
fandui: 反对
guanzhao: 关照、关着
duiyuan: 队员
chuyu: 出于
aoxiang: 翱翔
caijiang: 才将
gequ: 割去
zhaoxi: 朝西、朝夕
bianwei: 边围
fangzhi: 防止、防治
heshan: 和善、河山
hunyong: 昏庸、混用
changgan: 长杆
caile: 采了
jiasheng: 夹生
fenghou: 丰厚
chaoxue: 巢穴
caidui: 才对
guibai: 跪拜
guozhai: 国债
gaozhuang: 告状
dingliang: 定粮、定量
bingmo: 病魔
cuoguo: 错过
dufu: 镀覆
huixin: 回信
chumei: 出没
bieguan: 别管
binan: 避难
fuqiang: 腹腔、富强
changzu: 长足
ganqun: 干群
chongzhao: 冲着
bikou: 闭口
ganbie: 干瘪
feiyan: 肺炎
changlong: 昌隆、长龙
dianzhu: 电珠、店主
gangbao: 杠包
fengxian: 风险
heiban: 黑板
chuhan: 出汗
diaobai: 凋败
anji: 氨基、暗疾、暗记
haichan: 海产
daomu: 盗墓
diaodi: 调低
chouyun: 愁云
haihe: 海河
chaihuo: 拆伙
zhaoli: 朝里
chengzi: 橙子
fuwei: 抚慰
huanman: 还慢
gongchuang: 共创
erge: 儿歌
jiajiao: 家教
jiayuan: 家园
fengmang: 锋芒
huimu: 回目
chousuan: 筹算
cuanduo: 篡夺
hedan: 核弹
daoqi: 到期
dunran: 顿然
genxi: 根系
douqu: 逗趣
chutu: 出土
gaishi: 该是
beiyang: 北洋
baiwu: 白雾
chuchao: 初潮
banmian: 版面
guojing: 国境、过境
cizi: 次子
hemian: 河面
chunhou: 淳厚
ewai: 额外
anzhi: 安置、按置
dingxing: 定刑、定型、定性
duige: 队歌
guilian: 鬼脸
jiji: 积极、汲汲
bucai: 不才
dantian: 丹田
dingman: 订满
cibie: 辞别
fuchou: 腐臭
hengxiang: 横向
huozhong: 惑众
jifan: 几番
guaxue: 挂靴
changyin: 畅饮
hexu: 和煦
duzhai: 赌债
chaoyuan: 超员
fuzhuang: 服装
haodang: 浩荡
chenmian: 沉湎
hangdao: 航道
daihao: 带好
ama: 阿妈
diandong: 电动
chengren: 成人
huali: 花梨
chonghai: 虫害
fanzhao: 翻着、反照、泛着
jiajing: 嘉靖、家景、家境
fanchen: 翻沉、反衬
huogen: 祸根
huidao: 回到、回道
cuangai: 篡改、窜改
banxue: 办学
dengda: 瞪大
jita: 吉它
heshui: 喝水、河水
boshi: 剥蚀、博识、博士
caitou: 彩头
gaizai: 该在
baolv: 暴率
houhan: 后汉
cunzhuang: 村庄
baguan: 把关、罢官
huati: 滑梯、话题
chaosheng: 超声、超生
baomei: 胞妹
chaizhang: 拆帐
duoluo: 堕落
ganwang: 赶往
bucheng: 不成
baoshu: 报数
diaoqian: 调遣
bingdiao: 冰雕
haiwan: 海湾
haidi: 海堤、海底、海地
diange: 点歌
guanfang: 关防、官方
gangzhi: 刚直
bielai: 别来
baofu: 抱负、报复
chuna: 出纳
ciyao: 次要
jiguang: 激光
gengduo: 更多
baijian: 摆件、拜见
biezui: 别嘴
guoduo: 过多
haimian: 海绵、海面
caocheng: 草成
cuohe: 撮合
jizhe: 记者
anling: 按铃
baomu: 报幕
huangtang: 荒唐
guanzi: 关子、管自、罐子
dushen: 赌神
baiju: 败局
huolang: 豁朗
huancha: 还差
huaishi: 坏事
jichi: 疾驰
chanming: 阐明
huiyu: 毁于、毁誉、秽语
chidiao: 吃掉
bobing: 薄饼
changwu: 长物
guanzhuang: 冠状、罐装
angshou: 昂首
duhao: 都好
huangshan: 荒山、黄山、黄鳝
haofan: 浩繁
zhaozuo: 朝左
baikuo: 摆阔
buwang: 不忘
fangshou: 防守
dubi: 杜比
fengpei: 丰沛
dongxiang: 动向
duozhai: 躲债
dingzhu: 盯住、叮嘱
daozhong: 稻种
biaomian: 表面
danren: 担任
caipiao: 彩票
beimei: 北美
duzhuan: 杜撰
huanfang: 换房、换防
guogan: 果敢
husong: 护送
guandao: 关岛、官倒、管到、管道
huangpi: 荒僻
fanguang: 反光
hongfu: 洪福
dahao: 打好
bupa: 不怕
chenni: 沉溺
diaonan: 刁难
baomi: 苞米
chexiao: 撤销、撤消
guizhong: 贵重
baina: 白拿
erfei: 而非
anhei: 暗黑
gongpo: 攻破
buyue: 不悦
gangqia: 岗卡
douren: 逗人
hanshe: 寒舍
bangwei: 榜尾
huibo: 回波、回驳
buxin: 不信
baizhou: 白昼、摆轴
chongxian: 冲线
huzhi: 互质
caidi: 菜地
chuankou: 串口
gengjian: 更见
bowei: 泊位
chaijie: 拆借
banchu: 搬出
huofo: 活佛
feifa: 非法
bata: 吧嗒、把他、把它、把她
bantu: 斑秃、版图
huanbei: 还被
dingzhao: 盯着
erhua: 二话
baoming: 报名
gexin: 革新
changwai: 场外、厂外
dengwai: 等外
jiacai: 家财
chijing: 吃惊、赤径
buqiao: 不巧
huduan: 护短
diejiao: 跌跤
dianzu: 电阻
guayan: 寡言
huangwu: 荒芜
gangjing: 刚劲、钢精、港警
dezheng: 德政
anmai: 按脉
hunyuan: 浑圆
gongchen: 功臣
bingzhuang: 病状
benxi: 本息
duya: 毒牙
guijiu: 归咎
douhen: 逗哏
diantang: 店堂、殿堂
huzhao: 护照、护着
gedao: 割刀、割稻
diaozhuan: 掉转、调转
dongchuang: 冻疮
chailang: 豺狼
hada: 哈达
duanzao: 锻造
huangtong: 黄铜
benzhou: 本周
huachuan: 划船
diaoqi: 雕漆、吊起
gongquan: 拱圈
bifa: 笔法
hanguo: 韩国
chuipeng: 吹捧
gengda: 更大
budong: 不懂、不动
fangzi: 房子
guyi: 故意
gaikuang: 概况
chuida: 吹打、捶打
bahu: 跋扈
huimie: 毁灭
guanxi: 关系
anjian: 按键、案件
birang: 避让
bizhe: 笔者
honghua: 哄话
chuangjia: 疮痂
erdui: 而对
chongjue: 冲决
chuanmin: 船民
huagong: 画工
baixiong: 白熊
chenggong: 成功
chuhao: 除号
douji: 斗鸡
baixing: 败兴
guolai: 过来
cuoan: 错案
bingma: 兵马
ducao: 毒草、渡槽
bianyuan: 边缘、边远、扁圆
gangtie: 钢铁
guanshui: 关税、灌水
guandi: 官邸
erta: 而他、而她
guozhong: 过重
dongneng: 动能
caoban: 操办
huangzu: 皇族
daoqie: 盗窃
dalai: 打来
huanshao: 还少
bujian: 不见
caixian: 彩显
heqin: 和亲
bieniu: 别扭
beibao: 背包
deguo: 德国
ciling: 辞令
daduan: 打断
fengdi: 封底、风笛
caoqian: 草签
ende: 恩德
chongdang: 充当
chuxue: 初学
guanche: 贯彻
gaiguan: 概观
huangfei: 荒废
diechuan: 跌穿
canliang: 参量
daijin: 带进、殆尽
fenghai: 风害
canyi: 参议
chegu: 彻骨
bohua: 帛画
baidi: 白地
gouzhi: 购置
huangjin: 黄金
dikuai: 地块
jiling: 机灵、即令
houyuan: 后院
huae: 花萼
airong: 艾绒
huafen: 花粉、划分、划粉
cuoluo: 错落
chanfu: 搀扶
ayu: 阿谀
guose: 国色
danmo: 淡漠
guzao: 鼓噪
bulou: 补漏
baigu: 白骨
haigui: 海龟
dishui: 滴水
genggeng: 耿耿
guoxue: 国学
ersai: 耳塞
diangan: 电感
jiazheng: 家政
jiachu: 家畜
fangyuan: 房源
houzhe: 后辙、后者
guangbu: 广布
jipo: 击破
anjuan: 案卷
baxiu: 罢休
buwai: 不外
dida: 滴答、抵达
jice: 计策
fuzhang: 腹胀
fanjuan: 翻卷
guaigun: 拐棍
feiteng: 沸腾
dianrong: 电容
caigan: 才干
jiating: 家庭
dangyang: 荡漾
faan: 法案
dongyuan: 动员
cangwei: 舱位
zhaoni: 朝你
huase: 花色
guanmen: 关门
fugao: 腹稿、讣告
chenzhong: 沉重
haigou: 海狗
anhao: 安好、暗号
cidao: 刺刀
dishu: 底数
fenhua: 焚化
dilun: 涤纶
cuoai: 错爱
fanhang: 返航
huansheng: 环生
fengsheng: 丰盛、风声
faquan: 法权
guapai: 挂拍、挂牌
buyao: 补药、不要
hanzu: 汉族
fuzhong: 浮肿、附中
boying: 播映
guangjiao: 广角
huipiao: 汇票
diaozheng: 调整
guilai: 归来
fuyou: 浮游、赋有、富有
batian: 坝田
bule: 补了、不了
dabai: 打败
bengtan: 崩坍
hengdu: 横渡
airan: 蔼然
biecheng: 别称
guikou: 归口
dudan: 毒弹
huilong: 回笼、汇拢
huadiao: 花雕、花掉
guoti: 国体
daojia: 到家、道家
bingcuan: 冰镩
guoshi: 国事、国势、果实、过失、过时
daizi: 呆子、带子
jiashu: 家书、家属
daguo: 打过
fayuan: 法院
fubi: 腹壁
chuju: 初具、出局、出具、楚剧
dingan: 定案
chuanqi: 喘气、串气
jiajia: 家家、加价
fanghu: 防护
feiyao: 非要
genqian: 跟前
canting: 餐厅
duxue: 督学
aicheng: 爱称
daode: 道德
bizu: 鼻祖
bingtuan: 兵团
diaose: 掉色、调色
daole: 到了
gemo: 隔膜
baiyi: 白蚁
baoguang: 暴光
cunshang: 村上
huche: 胡扯
deshun: 得顺
binggun: 冰棍
gui*: 贵*
boxing: 勃兴
dejiu: 得救
fuyang: 抚养
guibing: 归并
biyi: 比翼、鄙意、笔译
angyang: 昂扬
fengsha: 风沙
biaodai: 表带
cunjin: 寸金
cunshe: 村舍
gualei: 瓜类
angsi: 盎司
houdai: 后代
buju: 不拘、不具
huangshu: 荒疏
canshi: 蚕食
bingshan: 冰山
fengyue: 风月
daodan: 捣蛋
gaorao: 告饶
fengchen: 风尘
baoduan: 报端
banci: 班次
beiming: 碑铭
dishou: 敌手
dacheng: 搭乘
emiu: 讹谬
guahuai: 挂怀
fengtao: 封套
huxiang: 互相
diandi: 点滴
duzi: 赌资、肚子
guimian: 柜面
dichu: 涤除、抵触、地处
bencun: 本村
baojing: 报警
hexia: 喝下
huosai: 活塞
beichou: 悲愁
chaoqi: 超期、潮起、潮气
baihe: 白喝、白鹤、拜贺
goucheng: 构成
gongke: 攻克、功课
gunre: 滚热
beita: 被他、被她
duchang: 赌场
bingying: 兵营
haibian: 海边
hengao: 很高
huiliu: 回流、汇流
baizhong: 白种、摆钟
bingru: 并入
fuzang: 腑脏
doujiang: 豆浆
bianzi: 鞭子、扁字
burong: 不容
caibei: 才被
baqiang: 八强
fanyou: 凡有
biru: 比如
chihuan: 迟缓
beichuang: 悲怆
bulie: 捕猎
gengjing: 更精
fengniao: 蜂鸟
heibang: 黑帮
henzao: 很早
changye: 长夜
erren: 二人
chongxin: 宠信
bengshuo: 甭说
huangshang: 皇上
diaocha: 调查
jitou: 机头
baise: 白色
duide: 堆得
jiazhu: 夹住、夹注
biezi: 别字
dingxin: 鼎新、定心
chuanshang: 穿上、船上
conghua: 葱花
gangpi: 钢皮
cangbai: 苍白
chugou: 除垢
haizao: 海藻
dunxia: 蹲下
cangxi: 藏戏
chaqing: 茶青、查清
biaoda: 表达
changci: 场次、长辞
huanxu: 还需、还须
benmin: 本民
fanpan: 反叛
chengdao: 称道
changgu: 长鼓
diaokou: 吊扣
bulu: 不露
dianliang: 掂量、电量
guowang: 国王、过往
guanhuai: 关怀
dixin: 地心
huabing: 滑冰、话柄
bukao: 补考、不靠
fukua: 浮夸
cangcang: 苍苍
bianxian: 边线
chongxia: 冲下
guipi: 桂皮
guifei: 贵妃
dehong: 德宏
chengle: 成了
hukou: 虎口、户口
guijiao: 硅胶
choujin: 抽筋
feiren: 非人、废人
ciguan: 辞官
genjue: 根绝
hanshu: 寒暑
guanqiang: 官腔
huanqin: 换亲
baozao: 暴躁
fengbing: 疯病
dezui: 得罪
bansheng: 半生
dekong: 得空
gouzhua: 钩爪
anhai: 暗害
duyu: 都与
gangzha: 钢渣
henyou: 很有
housheng: 吼声、后生
gongxiao: 功效
guanta: 管他
caipai: 彩排
huantan: 还谈
fenmu: 坟墓
dake: 搭客
chuzhan: 初战、出战、出站
duri: 度日
huyou: 护佑
gupiao: 股票
guanhu: 关乎
caidao: 才到、踩到、菜刀
ganyou: 甘油
diezi: 碟子
chuanbo: 船舶
ganwei: 甘为、甘味
daohui: 捣毁、到会
changzheng: 长征
huashuo: 话说
hanxian: 汗腺
huiqing: 回青、回请
huakai: 划开
heyan: 河沿
guyuan: 故园、雇员
dudou: 肚兜
bisuo: 比索
gundan: 滚蛋
bianyi: 贬义
fanfu: 翻覆、反复
houtian: 后天
diaozhuang: 吊装
daokou: 刀口、道口
caizhu: 财主
bingding: 兵丁
bieshu: 别墅
guigu: 硅谷
changlang: 长廊
fengxing: 风行
chanchu: 铲除
chizhao: 吃着
binglong: 并拢
